fips_code,BIRTHS_2023,DEATHS_2023,DOMESTIC_MIG_2023,GQ_ESTIMATES_2023,INTERNATIONAL_MIG_2023,NATURAL_CHG_2023,NET_MIG_2023,N_POP_CHG_2023,POP_ESTIMATE_2023,RESIDUAL_2023,R_BIRTH_2023,R_DEATH_2023,R_DOMESTIC_MIG_2023,R_INTERNATIONAL_MIG_2023,R_NATURAL_CHG_2023,R_NET_MIG_2023,Rural_Urban_Continuum_Code_2023
0,3653356,3148861,0,,1138989,504495,1138989,1643484,334914895,0,10.9,9.4,0,3.4,1.5,3.4,
1000,58251,59813,30744,144014,5384,-1562,36128,34565,5108468,-1,11.4,11.7,6,1.1,-0.3,7.1,
10000,10725,10897,10320,23737,2277,-172,12597,12431,1031890,6,10.5,10.6,10.1,2.2,-0.2,12.3,
10001,2153,2169,1788,5279,263,-16,2051,2031,189789,-4,11.4,11.5,9.5,1.4,-0.1,10.9,3
10003,6080,5527,1203,15686,1582,553,2785,3338,578592,0,10.5,9.6,2.1,2.7,1,4.8,1
10005,2492,3201,7329,2772,432,-709,7761,7062,263509,10,9.6,12.3,28.2,1.7,-2.7,29.9,4
1001,714,621,491,484,34,93,525,616,60342,-2,11.9,10.3,8.2,0.6,1.5,8.7,2
1003,2531,2640,6804,3493,291,-109,7095,6976,253507,-10,10.1,10.6,27.2,1.2,-0.4,28.4,3
1005,267,350,-45,2702,13,-83,-32,-115,24585,0,10.8,14.2,-1.8,0.5,-3.4,-1.3,6
1007,240,290,-69,1894,1,-50,-68,-118,21868,0,10.9,13.2,-3.1,0,-2.3,-3.1,1
1009,698,776,358,616,24,-78,382,300,59816,-4,11.7,13,6,0.4,-1.3,6.4,1
1011,102,133,-219,1615,6,-31,-213,-246,9897,-2,10.2,13.3,-21.9,0.6,-3.1,-21.3,8
1013,212,299,-207,285,8,-87,-199,-286,18382,0,11.4,16.1,-11.2,0.4,-4.7,-10.7,6
1015,1346,1649,923,5936,29,-303,952,649,116429,0,11.6,14.2,7.9,0.2,-2.6,8.2,3
1017,398,511,-26,860,55,-113,29,-85,34079,-1,11.7,15,-0.8,1.6,-3.3,0.8,6
1019,230,409,482,278,14,-179,496,313,25666,-4,9,16,18.9,0.5,-7,19.4,8
1021,548,588,577,388,49,-40,626,583,46431,-3,11.9,12.7,12.5,1.1,-0.9,13.6,1
1023,108,200,-88,66,2,-92,-86,-179,12252,-1,8.8,16.2,-7.1,0.2,-7.5,-7,9
1025,293,366,-165,372,0,-73,-165,-237,22337,1,13,16.3,-7.3,0,-3.3,-7.3,9
1027,159,230,2,258,-3,-71,-1,-72,14111,0,11.2,16.3,0.1,-0.2,-5,-0.1,9
1029,177,229,322,174,-1,-52,321,267,15639,-2,11.4,14.8,20.8,-0.1,-3.4,20.7,8
1031,676,630,695,761,68,46,763,803,55643,-6,12.2,11.4,12.6,1.2,0.8,13.8,4
1033,636,801,489,407,47,-165,536,368,58361,-3,10.9,13.8,8.4,0.8,-2.8,9.2,3
1035,134,205,20,128,0,-71,20,-50,11174,1,12,18.3,1.8,0,-6.3,1.8,9
1037,89,174,49,310,-1,-85,48,-39,10268,-2,8.7,16.9,4.8,-0.1,-8.3,4.7,8
1039,418,653,589,778,-1,-235,588,349,37952,-4,11.1,17.3,15.6,0,-6.2,15.6,6
1041,157,225,95,153,27,-68,122,53,13101,-1,12,17.2,7.3,2.1,-5.2,9.3,8
1043,1015,1146,1471,1257,16,-131,1487,1353,92016,-3,11.1,12.5,16.1,0.2,-1.4,16.3,4
1045,692,623,257,757,49,69,306,376,49871,1,13.9,12.5,5.2,1,1.4,6.2,4
1047,428,572,-458,476,37,-144,-421,-564,36165,1,11.7,15.7,-12.6,1,-4,-11.6,4
1049,835,945,495,848,100,-110,595,487,72569,2,11.5,13.1,6.8,1.4,-1.5,8.2,6
1051,935,942,822,5429,29,-7,851,841,90441,-3,10.4,10.5,9.1,0.3,-0.1,9.5,2
1053,428,582,74,2067,2,-154,76,-78,36558,0,11.7,15.9,2,0.1,-4.2,2.1,6
1055,1170,1630,733,1592,69,-460,802,338,103241,-4,11.4,15.8,7.1,0.7,-4.5,7.8,3
1057,180,276,-18,303,0,-96,-18,-115,15967,-1,11.2,17.2,-1.1,0,-6,-1.1,8
1059,430,449,-144,424,54,-19,-90,-108,31802,1,13.5,14.1,-4.5,1.7,-0.6,-2.8,6
1061,294,451,369,266,17,-157,386,228,26988,-1,10.9,16.8,13.7,0.6,-5.8,14.4,3
1063,84,126,-68,60,0,-42,-68,-111,7341,-1,11.4,17,-9.2,0,-5.7,-9.2,2
1065,213,251,327,181,1,-38,328,289,14888,-1,14.4,17,22.2,0.1,-2.6,22.2,2
1067,173,261,319,140,0,-88,319,229,17899,-2,9.7,14.7,17.9,0,-4.9,17.9,3
1069,1306,1349,374,822,83,-43,457,415,108462,1,12.1,12.5,3.5,0.8,-0.4,4.2,3
1071,549,841,809,603,29,-292,838,544,53467,-2,10.3,15.8,15.2,0.5,-5.5,15.8,6
1073,7967,7573,-3417,20631,818,394,-2599,-2189,662895,16,12,11.4,-5.1,1.2,0.6,-3.9,1
1075,155,238,38,152,-1,-83,37,-45,13661,1,11.3,17.4,2.8,-0.1,-6.1,2.7,8
1077,948,1183,1103,4676,58,-235,1161,939,96814,13,9.8,12.3,11.4,0.6,-2.4,12.1,3
1079,386,492,420,219,-1,-106,419,315,33502,2,11.6,14.8,12.6,0,-3.2,12.6,3
1081,1899,1313,1357,5213,575,586,1932,2517,183215,-1,10.4,7.2,7.5,3.2,3.2,10.6,3
1083,1204,1040,3523,3054,104,164,3627,3786,114654,-5,10.7,9.2,31.2,0.9,1.5,32.2,2
1085,120,169,-17,183,1,-49,-16,-66,9717,-1,12.3,17.3,-1.7,0.1,-5,-1.6,2
1087,162,241,-107,2053,24,-79,-83,-162,18370,0,8.8,13.1,-5.8,1.3,-4.3,-4.5,3
1089,4470,3616,7340,11879,789,854,8129,8995,412600,12,11,8.9,18,1.9,2.1,19.9,2
1091,220,301,-41,239,14,-81,-27,-107,18684,1,11.7,16.1,-2.2,0.7,-4.3,-1.4,6
1093,309,441,192,734,1,-132,193,62,29244,1,10.6,15.1,6.6,0,-4.5,6.6,9
1095,1535,1256,866,1020,181,279,1047,1328,100756,2,15.3,12.5,8.7,1.8,2.8,10.5,4
1097,5075,4765,-405,7773,325,310,-80,242,411640,12,12.3,11.6,-1,0.8,0.8,-0.2,2
1099,231,319,-98,193,1,-88,-97,-183,19229,2,12,16.5,-5.1,0.1,-4.6,-5,8
11000,7627,5020,-1509,37601,6969,2607,5460,8023,678972,-44,11.3,7.4,-2.2,10.3,3.9,8.1,
11001,7627,5020,-1509,37601,6969,2607,5460,8023,678972,-44,11.3,7.4,-2.2,10.3,3.9,8.1,1
1101,3003,2360,-2418,8732,439,643,-1979,-1321,224980,15,13.3,10.5,-10.7,1.9,2.8,-8.8,2
1103,1461,1506,840,2229,106,-45,946,902,125133,1,11.7,12.1,6.7,0.9,-0.4,7.6,3
1105,89,141,-114,314,1,-52,-113,-166,7738,-1,11.4,18,-14.6,0.1,-6.6,-14.4,8
1107,186,283,22,1983,14,-97,36,-61,18688,0,9.9,15.1,1.2,0.7,-5.2,1.9,2
1109,360,396,100,2079,66,-36,166,129,33137,-1,10.9,12,3,2,-1.1,5,6
1111,249,336,404,590,10,-87,414,326,22786,-1,11,14.9,17.9,0.4,-3.8,18.3,8
1113,688,710,149,530,24,-22,173,150,58744,-1,11.7,12.1,2.5,0.4,-0.4,2.9,2
1115,1032,1156,1777,2109,18,-124,1795,1671,95552,0,10.9,12.2,18.8,0.2,-1.3,19,1
1117,2390,1727,2078,3330,248,663,2326,2967,233000,-22,10.3,7.5,9,1.1,2.9,10,1
1119,114,161,-136,922,21,-47,-115,-162,11727,0,9.7,13.6,-11.5,1.8,-4,-9.7,8
1121,871,1147,633,2516,25,-276,658,384,81132,2,10.8,14.2,7.8,0.3,-3.4,8.1,4
1123,392,637,-11,680,19,-245,8,-236,40677,1,9.6,15.6,-0.3,0.5,-6,0.2,6
1125,2510,2004,-128,21021,298,506,170,683,237373,7,10.6,8.5,-0.5,1.3,2.1,0.7,2
1127,808,1096,539,1081,39,-288,578,290,64728,0,12.5,17,8.3,0.6,-4.5,8.9,1
1129,187,229,-29,125,-1,-42,-30,-72,15022,0,12.4,15.2,-1.9,-0.1,-2.8,-2,8
1131,116,166,-147,228,2,-50,-145,-195,9944,0,11.6,16.5,-14.6,0.2,-5,-14.4,9
1133,249,388,-8,343,18,-139,10,-130,23611,-1,10.5,16.4,-0.3,0.8,-5.9,0.4,8
12000,223578,231181,194438,480002,178432,-7603,372870,365205,22610726,-62,10,10.3,8.7,8,-0.3,16.6,
12001,2679,2249,-95,19394,1606,430,1511,1953,285994,12,9.4,7.9,-0.3,5.6,1.5,5.3,2
12003,354,345,553,1538,20,9,573,582,28368,0,12.6,12.3,19.7,0.7,0.3,20.4,1
12005,2127,2188,4911,3180,707,-61,5618,5559,190769,2,11.3,11.6,26.1,3.8,-0.3,29.9,3
12007,306,367,632,2618,-7,-61,625,562,27858,-2,11.1,13.3,22.9,-0.3,-2.2,22.7,6
12009,5217,8261,14886,8543,1440,-3044,16326,13272,643979,-10,8.2,13,23.4,2.3,-4.8,25.6,2
12011,21028,16483,-14303,15749,25427,4545,11124,15642,1962531,-27,10.8,8.4,-7.3,13,2.3,5.7,1
12013,138,225,83,1564,9,-87,92,5,13470,0,10.2,16.7,6.2,0.7,-6.5,6.8,8
12015,1095,3103,5057,3763,492,-2008,5549,3552,206134,11,5.4,15.2,24.7,2.4,-9.8,27.2,3
12017,1045,3149,6183,2843,113,-2104,6296,4188,166696,-4,6.3,19.1,37.6,0.7,-12.8,38.2,3
12019,2303,2355,5550,2456,333,-52,5883,5805,232439,-26,10,10.3,24.2,1.5,-0.2,25.6,1
12021,3388,4166,4197,4934,3382,-778,7579,6794,404310,-7,8.5,10.4,10.5,8.4,-1.9,18.9,2
12023,751,1045,1324,4099,163,-294,1487,1193,73063,0,10.4,14.4,18.3,2.2,-4.1,20.5,4
12027,409,435,548,3129,132,-26,680,659,35979,5,11.5,12.2,15.4,3.7,-0.7,19.1,6
12029,156,285,470,1647,2,-129,472,345,17465,2,9,16.5,27.2,0.1,-7.5,27.3,8
12031,12873,9766,5112,24378,5507,3107,10619,13811,1030822,85,12.6,9.5,5,5.4,3,10.4,1
12033,3761,4012,2464,18440,823,-251,3287,3068,326928,32,11.6,12.3,7.6,2.5,-0.8,10.1,2
12035,874,1695,5286,781,219,-821,5505,4681,131439,-3,6.8,13.1,40.9,1.7,-6.4,42.6,2
12037,88,188,194,1159,8,-100,202,102,12594,0,7,15,15.5,0.6,-8,16.1,8
12039,486,605,493,2036,67,-119,560,440,43833,-1,11.1,13.9,11.3,1.5,-2.7,12.8,2
12041,209,260,575,998,63,-51,638,585,19587,-2,10.8,13.5,29.8,3.3,-2.6,33.1,2
12043,72,162,371,1939,40,-90,411,323,12786,2,5.7,12.8,29.4,3.2,-7.1,32.6,8
12045,113,242,502,1799,19,-129,521,394,15693,2,7.3,15.6,32.4,1.2,-8.3,33.6,8
12047,167,207,315,1540,2,-40,317,277,13471,0,12.5,15.5,23.6,0.2,-3,23.8,8
12049,361,328,23,1922,53,33,76,109,25760,0,14,12.8,0.9,2.1,1.3,3,6
12051,562,412,1392,2257,404,150,1796,1942,43333,-4,13.3,9.7,32.9,9.5,3.5,42.4,4
12053,1649,3199,7086,2099,345,-1550,7431,5872,212807,-9,7.9,15.2,33.8,1.6,-7.4,35.4,1
12055,870,1907,2700,1413,307,-1037,3007,1965,107614,-5,8.2,17.9,25.3,2.9,-9.7,28.2,3
12057,17429,12440,3301,33899,13707,4989,17008,22091,1535564,94,11.4,8.2,2.2,9,3.3,11.2,1
12059,229,320,381,1658,0,-91,381,291,19944,1,11.6,16.2,19.2,0,-4.6,19.2,8
12061,1273,2501,3296,1441,465,-1228,3761,2528,169795,-5,7.6,14.8,19.6,2.8,-7.3,22.3,3
12063,521,715,511,6736,50,-194,561,367,48622,0,10.8,14.8,10.5,1,-4,11.6,6
12065,136,209,423,1205,31,-73,454,381,15450,0,8.9,13.7,27.7,2,-4.8,29.8,2
12067,71,112,338,934,5,-41,343,301,8078,-1,9,14.1,42.6,0.6,-5.2,43.3,9
12069,3689,5126,14670,4373,1150,-1437,15820,14372,424462,-11,8.8,12.3,35.2,2.8,-3.4,37.9,1
12071,7477,8597,8374,14019,4906,-1120,13280,12182,834573,22,9,10.4,10.1,5.9,-1.4,16,2
12073,2791,2309,-1941,17867,1075,482,-866,-369,296913,15,9.4,7.8,-6.5,3.6,1.6,-2.9,2
12075,395,670,1491,279,75,-275,1566,1292,46545,1,8.6,14.6,32.5,1.6,-6,34.1,2
12077,74,78,96,1537,0,-4,96,93,7706,1,9.7,10.2,12.5,0,-0.5,12.5,8
12079,173,302,360,1555,57,-129,417,289,18519,1,9.4,16.4,19.6,3.1,-7,22.7,8
12081,3761,4744,11300,6250,1597,-983,12897,11926,441095,12,8.6,10.9,26,3.7,-2.3,29.6,2
12083,3638,6118,15167,9084,848,-2480,16015,13522,409959,-13,9,15.2,37.6,2.1,-6.2,39.7,2
12085,1294,2241,1838,4789,441,-947,2279,1328,163315,-4,8,13.8,11.3,2.7,-5.8,14,2
12086,29339,22335,-47597,42193,54457,7004,6860,13811,2686867,-53,10.9,8.3,-17.8,20.3,2.6,2.6,1
12087,734,799,-1413,984,482,-65,-931,-1004,80614,-8,9,9.9,-17.4,5.9,-0.8,-11.5,4
12089,851,1126,3940,733,15,-275,3955,3675,101501,-5,8.5,11.3,39.5,0.2,-2.8,39.7,1
12091,2686,2136,473,4341,962,550,1435,2000,218464,15,12.4,9.8,2.2,4.4,2.5,6.6,2
12093,552,586,1029,2160,59,-34,1088,1054,41427,0,13.5,14.3,25.2,1.4,-0.8,26.6,4
12095,16620,9597,-6560,39527,19160,7023,12600,19655,1471416,32,11.4,6.6,-4.5,13.1,4.8,8.6,1
12097,4916,3104,7418,2871,5994,1812,13412,15241,437784,17,11.4,7.2,17.2,13.9,4.2,31.2,1
12099,15166,15837,-162,30346,14841,-671,14679,13934,1533801,-74,9.9,10.4,-0.1,9.7,-0.4,9.6,1
12101,5625,7184,23750,8227,1691,-1559,25441,23855,632996,-27,9.1,11.6,38.2,2.7,-2.5,41,1
12103,7488,12433,1693,21292,3087,-4945,4780,-196,961596,-31,7.8,12.9,1.8,3.2,-5.1,5,1
12105,8932,8352,26029,16855,3335,580,29364,29948,818330,4,11.1,10.4,32.4,4.2,0.7,36.6,2
12107,821,1233,1542,1270,82,-412,1624,1219,75955,7,10.9,16.4,20.5,1.1,-5.5,21.6,4
12109,2469,2486,12309,3979,804,-17,13113,13038,320110,-58,7.9,7.9,39.3,2.6,-0.1,41.8,1
12111,3605,4021,14011,2917,1125,-416,15136,14700,373586,-20,9.8,11,38.3,3.1,-1.1,41.3,2
12113,2075,1929,4703,5434,128,146,4831,4963,203162,-14,10.3,9.6,23.4,0.6,0.7,24.1,2
12115,3003,6402,8526,8576,1354,-3399,9880,6461,469013,-20,6.4,13.7,18.3,2.9,-7.3,21.2,2
12117,4677,3987,1923,4938,3039,690,4962,5648,484271,-4,9.7,8.3,4,6.3,1.4,10.3,1
12119,541,2530,8684,8389,104,-1989,8788,6798,151565,-1,3.7,17.1,58.6,0.7,-13.4,59.3,3
12121,442,709,977,2618,15,-267,992,725,46130,0,9.7,15.5,21.3,0.3,-5.8,21.7,6
12123,223,329,294,1635,80,-106,374,269,21582,1,10.4,15.3,13.7,3.7,-4.9,17.4,6
12125,152,248,114,3857,0,-96,114,18,15532,0,9.8,16,7.3,0,-6.2,7.3,8
12127,5051,8054,12284,17947,1398,-3003,13682,10692,590357,13,8.6,13.8,21,2.4,-5.1,23.4,2
12129,342,410,1349,2852,1,-68,1350,1280,36449,-2,9.6,11.4,37.7,0,-1.9,37.7,2
12131,958,863,2761,2143,94,95,2855,2950,86354,0,11.3,10.2,32.5,1.1,1.1,33.6,2
12133,278,370,247,2074,42,-92,289,197,25602,0,10.9,14.5,9.7,1.6,-3.6,11.3,3
13000,125664,97847,58206,254664,30119,27817,88325,116077,11029227,-65,11.5,8.9,5.3,2.7,2.5,8.1,
13001,207,238,16,368,34,-31,50,20,18457,1,11.2,12.9,0.9,1.8,-1.7,2.7,7
13003,131,125,41,20,85,6,126,133,8293,1,15.9,15.2,5,10.3,0.7,15.3,9
13005,133,166,-18,391,2,-33,-16,-49,11124,0,11.9,14.9,-1.6,0.2,-3,-1.4,9
13007,27,43,-38,0,5,-16,-33,-49,2743,0,9.8,15.5,-13.7,1.8,-5.8,-11.9,8
13009,386,525,-110,4892,13,-139,-97,-237,43396,-1,8.9,12.1,-2.5,0.3,-3.2,-2.2,4
13011,245,241,444,15,0,4,444,447,19789,-1,12.5,12.3,22.7,0,0.2,22.7,8
13013,1151,800,3087,425,109,351,3196,3547,92792,0,12.6,8.8,33.9,1.2,3.9,35.1,1
13015,1326,1139,1953,1019,79,187,2032,2226,115041,7,11.6,10,17.1,0.7,1.6,17.8,1
13017,211,273,128,332,4,-62,132,71,17128,1,12.3,16,7.5,0.2,-3.6,7.7,7
13019,229,259,387,136,1,-30,388,355,18570,-3,12.5,14.1,21,0.1,-1.6,21.1,8
13021,2060,1916,133,5195,106,144,239,386,156512,3,13.2,12.3,0.9,0.7,0.9,1.5,3
13023,128,171,232,867,-2,-43,230,186,12465,-1,10.3,13.8,18.8,-0.2,-3.5,18.6,6
13025,208,246,206,64,23,-38,229,191,18401,0,11.4,13.4,11.3,1.3,-2.1,12.5,3
13027,161,220,-15,415,36,-59,21,-39,16245,-1,9.9,13.5,-0.9,2.2,-3.6,1.3,3
13029,628,340,1172,234,62,288,1234,1521,49739,-1,12.8,6.9,23.9,1.3,5.9,25.2,2
13031,855,674,1047,5986,60,181,1107,1289,84327,1,10.2,8.1,12.5,0.7,2.2,13.2,4
13033,270,276,6,206,3,-6,9,4,24438,1,11,11.3,0.2,0.1,-0.2,0.4,2
13035,293,343,170,2930,22,-50,192,142,26887,0,10.9,12.8,6.3,0.8,-1.9,7.2,1
13037,45,65,0,1683,3,-20,3,-17,5457,0,8.2,11.9,0,0.5,-3.7,0.5,8
13039,767,491,832,2243,35,276,867,1147,58118,4,13.3,8.5,14.5,0.6,4.8,15.1,4
13043,145,195,148,280,-2,-50,146,97,11059,1,13.2,17.7,13.4,-0.2,-4.5,13.3,9
13045,1567,1270,2131,3061,143,297,2274,2568,127098,-3,12.5,10.1,16.9,1.1,2.4,18.1,1
13047,573,816,327,485,-13,-243,314,74,68910,3,8.3,11.8,4.7,-0.2,-3.5,4.6,2
13049,122,154,174,2507,1,-32,175,146,12934,3,9.5,12,13.5,0.1,-2.5,13.6,8
13051,3676,2829,972,13396,811,847,1783,2630,303655,0,12.2,9.4,3.2,2.7,2.8,5.9,2
13053,174,38,-262,2112,46,136,-216,-85,8661,-5,20,4.4,-30.1,5.3,15.6,-24.8,2
13055,247,375,353,1241,33,-128,386,260,25222,2,9.8,14.9,14.1,1.3,-5.1,15.4,6
13057,2944,1984,3993,2219,450,960,4443,5408,286602,5,10.4,7,14.1,1.6,3.4,15.6,1
13059,1331,888,-672,11360,443,443,-229,207,129933,-7,10.3,6.8,-5.2,3.4,3.4,-1.8,3
13061,28,45,10,54,6,-17,16,0,2853,1,9.8,15.8,3.5,2.1,-6,5.6,9
13063,3596,2194,-2364,5101,859,1402,-1505,-99,298300,4,12.1,7.4,-7.9,2.9,4.7,-5,1
13065,94,85,55,163,4,9,59,67,6746,-1,14,12.7,8.2,0.6,1.3,8.8,8
13067,8847,4858,-3010,10307,3861,3989,851,4903,776743,63,11.4,6.3,-3.9,5,5.2,1.1,1
13069,566,498,-88,2897,86,68,-2,70,43317,4,13.1,11.5,-2,2,1.6,0,7
13071,622,577,84,907,208,45,292,337,46167,0,13.5,12.5,1.8,4.5,1,6.3,6
13073,1835,1211,1840,1257,246,624,2086,2691,165162,-19,11.2,7.4,11.2,1.5,3.8,12.7,2
13075,222,238,264,272,57,-16,321,305,17714,0,12.6,13.6,15,3.2,-0.9,18.3,6
13077,1688,1321,2452,951,203,367,2655,3013,155892,-9,10.9,8.6,15.9,1.3,2.4,17.2,1
13079,100,202,211,125,0,-102,211,108,12277,-1,8.2,16.5,17.3,0,-8.3,17.3,3
13081,242,282,-53,413,-3,-40,-56,-98,19631,-2,12.3,14.3,-2.7,-0.2,-2,-2.8,6
13083,126,230,176,567,6,-104,182,75,16165,-3,7.8,14.3,10.9,0.4,-6.4,11.3,2
13085,333,298,1489,119,21,35,1510,1543,31732,-2,10.8,9.6,48.1,0.7,1.1,48.8,1
13087,351,377,84,911,10,-26,94,68,29087,0,12.1,13,2.9,0.3,-0.9,3.2,6
13089,10127,5199,-8049,12451,4427,4928,-3622,1213,762992,-93,13.3,6.8,-10.6,5.8,6.5,-4.8,1
13091,182,291,-7,1803,20,-109,13,-97,19776,-1,9.2,14.7,-0.4,1,-5.5,0.7,7
13093,98,158,411,1772,39,-60,450,396,10981,6,9.1,14.7,38.1,3.6,-5.6,41.7,8
13095,1101,1066,-359,2432,70,35,-289,-250,82645,4,13.3,12.9,-4.3,0.8,0.4,-3.5,3
13097,1698,1142,932,781,233,556,1165,1707,149160,-14,11.4,7.7,6.3,1.6,3.7,7.9,1
13099,117,175,60,183,0,-58,60,3,10563,1,11.1,16.6,5.7,0,-5.5,5.7,8
13101,49,35,7,0,3,14,10,23,3709,-1,13.3,9.5,1.9,0.8,3.8,2.7,3
13103,847,597,2250,366,10,250,2260,2507,71541,-3,12.1,8.5,32,0.1,3.6,32.2,2
13105,223,306,220,218,3,-83,223,140,20013,0,11.2,15.3,11,0.2,-4.2,11.2,6
13107,288,338,200,1495,21,-50,221,173,23119,2,12.5,14.7,8.7,0.9,-2.2,9.6,7
13109,122,133,104,618,3,-11,107,95,10754,-1,11.4,12.4,9.7,0.3,-1,10,8
13111,186,434,476,82,-3,-248,473,222,25955,-3,7.2,16.8,18.4,-0.1,-9.6,18.3,8
13113,916,1061,1236,703,307,-145,1543,1370,123351,-28,7.5,8.6,10.1,2.5,-1.2,12.6,1
13115,1119,1267,608,4200,216,-148,824,676,100113,0,11.2,12.7,6.1,2.2,-1.5,8.3,3
13117,2411,1559,3704,1298,1061,852,4765,5575,272887,-42,8.9,5.8,13.7,3.9,3.2,17.6,1
13119,279,341,668,798,36,-62,704,636,24782,-6,11.4,13.9,27.3,1.5,-2.5,28.8,8
13121,11842,7153,-4327,33461,4986,4689,659,5407,1079105,59,11,6.6,-4,4.6,4.4,0.6,1
13123,297,424,563,249,20,-127,583,457,32860,1,9.1,13,17.3,0.6,-3.9,17.9,6
13125,32,50,45,56,0,-18,45,26,2954,-1,10.9,17,15.3,0,-6.1,15.3,9
13127,900,1032,1045,2267,114,-132,1159,1027,86172,0,10.5,12,12.2,1.3,-1.5,13.5,3
13129,660,688,867,490,64,-28,931,902,59757,-1,11.1,11.6,14.6,1.1,-0.5,15.7,4
13131,298,328,64,158,37,-30,101,72,26066,1,11.4,12.6,2.5,1.4,-1.2,3.9,6
13133,141,254,691,94,30,-113,721,611,20722,3,6.9,12.4,33.8,1.5,-5.5,35.3,8
13135,11245,5081,-5069,5934,6165,6164,1096,7353,983526,93,11.5,5.2,-5.2,6.3,6.3,1.1,1
13137,526,552,1212,2739,107,-26,1319,1292,48757,-1,10.9,11.5,25.2,2.2,-0.5,27.4,6
13139,2694,1758,3027,2396,671,936,3698,4646,217267,12,12.5,8.2,14.1,3.1,4.4,17.2,3
13141,51,148,353,1315,2,-97,355,259,8676,1,6,17.3,41.3,0.2,-11.3,41.5,9
13143,345,418,759,179,-1,-73,758,683,32038,-2,10.9,13.2,23.9,0,-2.3,23.9,1
13145,305,334,410,453,19,-29,429,397,36654,-3,8.4,9.2,11.2,0.5,-0.8,11.8,2
13147,266,392,790,688,7,-126,797,670,27556,-1,9.8,14.4,29,0.3,-4.6,29.3,6
13149,114,167,371,105,0,-53,371,318,12034,0,9.6,14.1,31.2,0,-4.5,31.2,1
13151,2777,1922,5076,1334,252,855,5328,6141,254613,-42,11,7.6,20.2,1,3.4,21.2,1
13153,2033,1454,1496,1887,131,579,1627,2199,171974,-7,11.9,8.5,8.8,0.8,3.4,9.5,3
13155,99,150,57,264,2,-51,59,6,9120,-2,10.9,16.5,6.3,0.2,-5.6,6.5,9
13157,1040,756,4209,603,126,284,4335,4606,88615,-13,12,8.8,48.8,1.5,3.3,50.2,4
13159,180,197,484,73,13,-17,497,476,16455,-4,11.1,12.1,29.8,0.8,-1,30.6,1
13161,163,212,61,105,3,-49,64,15,14906,0,10.9,14.2,4.1,0.2,-3.3,4.3,9
13163,166,266,-18,527,8,-100,-10,-111,15183,-1,10.9,17.5,-1.2,0.5,-6.6,-0.7,8
13165,94,129,-1,1130,7,-35,6,-28,8627,1,10.9,14.9,-0.1,0.8,-4.1,0.7,9
13167,97,138,107,1853,4,-41,111,71,9282,1,10.5,14.9,11.6,0.4,-4.4,12,9
13169,253,354,562,303,0,-101,562,457,28969,-4,8.8,12.3,19.6,0,-3.5,19.6,3
13171,222,254,952,740,6,-32,958,928,20401,2,11.1,12.7,47.8,0.3,-1.6,48.1,6
13173,129,114,187,356,74,15,261,275,10452,-1,12.5,11.1,18.1,7.2,1.5,25.3,3
13175,609,675,229,875,69,-66,298,231,49941,-1,12.2,13.5,4.6,1.4,-1.3,6,4
13177,315,299,154,988,26,16,180,194,33872,-2,9.3,8.9,4.6,0.8,0.5,5.3,3
13179,1382,518,251,4433,175,864,426,1291,69210,1,20.2,7.6,3.7,2.6,12.6,6.2,3
13181,87,113,43,26,3,-26,46,20,7879,0,11.1,14.4,5.5,0.4,-3.3,5.8,2
13183,278,145,1055,300,12,133,1067,1199,19594,-1,14.6,7.6,55.5,0.6,7,56.2,3
13185,1618,1088,579,4791,97,530,676,1213,120712,7,13.5,9.1,4.8,0.8,4.4,5.6,3
13187,324,373,526,3924,74,-49,600,552,35258,1,9.3,10.7,15,2.1,-1.4,17.2,1
13189,265,298,147,198,-6,-33,141,109,21799,1,12.2,13.7,6.8,-0.3,-1.5,6.5,2
13191,96,193,415,55,1,-97,416,318,11501,-1,8.5,17,36.6,0.1,-8.6,36.7,3
13193,124,175,83,2009,9,-51,92,40,11817,-1,10.5,14.8,7,0.8,-4.3,7.8,8
13195,403,382,721,144,-1,21,720,741,32191,0,12.7,12,22.7,0,0.7,22.6,3
13197,71,122,40,76,15,-51,55,4,7440,0,9.5,16.4,5.4,2,-6.9,7.4,2
13199,241,327,126,70,0,-86,126,41,20931,1,11.5,15.6,6,0,-4.1,6,1
13201,56,114,35,156,-1,-58,34,-27,5747,-3,9.7,19.8,6.1,-0.2,-10.1,5.9,9
13205,234,282,-24,1319,-3,-48,-27,-78,21114,-3,11.1,13.3,-1.1,-0.1,-2.3,-1.3,6
13207,268,359,1247,1377,5,-91,1252,1156,30625,-5,8.9,11.9,41.5,0.2,-3,41.7,3
13209,107,134,128,714,17,-27,145,118,8761,0,12.3,15.4,14.7,2,-3.1,16.7,9
13211,210,257,483,198,3,-47,486,436,21460,-3,9.9,12.1,22.7,0.1,-2.2,22.9,1
13213,454,490,660,239,1,-36,661,625,41035,0,11.1,12,16.2,0,-0.9,16.2,3
13215,2700,2140,-1488,6235,368,560,-1120,-555,201877,5,13.4,10.6,-7.4,1.8,2.8,-5.5,2
13217,1306,1055,1859,1526,280,251,2139,2383,120135,-7,11,8.9,15.6,2.4,2.1,18,1
13219,356,333,491,148,54,23,545,558,44182,-10,8.1,7.6,11.2,1.2,0.5,12.4,3
13221,162,187,245,72,4,-25,249,223,15754,-1,10.4,12,15.7,0.3,-1.6,15.9,3
13223,2007,1223,3326,648,320,784,3646,4411,183164,-19,11.1,6.8,18.4,1.8,4.3,20.1,1
13225,310,362,366,1459,4,-52,370,319,28805,1,10.8,12.6,12.8,0.1,-1.8,12.9,3
13227,317,456,1287,303,-5,-139,1282,1144,35969,1,9,12.9,36.4,-0.1,-3.9,36.2,1
13229,253,276,258,193,-1,-23,257,235,20425,1,12.5,13.6,12.7,0,-1.1,12.7,8
13231,196,245,554,230,3,-49,557,506,20461,-2,9.7,12.1,27.4,0.1,-2.4,27.6,1
13233,584,574,519,269,22,10,541,554,44223,3,13.3,13.1,11.8,0.5,0.2,12.3,4
13235,96,158,195,1304,1,-62,196,132,10095,-2,9.6,15.8,19.4,0.1,-6.2,19.5,8
13237,211,339,317,151,7,-128,324,196,23129,0,9.2,14.7,13.8,0.3,-5.6,14.1,8
13239,18,43,46,0,0,-25,46,21,2280,0,7.9,18.9,20.3,0,-11,20.3,8
13241,151,256,254,187,28,-105,282,175,17442,-2,8.7,14.8,14.6,1.6,-6.1,16.2,9
13243,57,106,-1,146,3,-49,2,-48,6078,-1,9.3,17.4,-0.2,0.5,-8,0.3,8
13245,2688,2245,-1550,10973,163,443,-1387,-930,205414,14,13.1,10.9,-7.5,0.8,2.2,-6.7,2
13247,974,833,784,899,122,141,906,1042,95987,-5,10.2,8.7,8.2,1.3,1.5,9.5,1
13249,50,57,35,0,0,-7,35,29,4526,1,11.1,12.6,7.8,0,-1.6,7.8,8
13251,153,211,264,245,0,-58,264,204,14174,-2,10.9,15,18.8,0,-4.1,18.8,8
13253,96,143,-7,121,2,-47,-5,-52,9092,0,10.5,15.7,-0.8,0.2,-5.2,-0.5,8
13255,848,927,968,858,50,-79,1018,938,69946,-1,12.2,13.3,13.9,0.7,-1.1,14.7,1
13257,297,422,593,768,9,-125,602,482,27228,5,11,15.6,22,0.3,-4.6,22.3,7
13259,33,80,9,776,109,-47,118,70,4674,-1,7.1,17.2,1.9,23.5,-10.1,25.4,2
13261,349,390,49,1557,17,-41,66,26,28890,1,12.1,13.5,1.7,0.6,-1.4,2.3,6
13263,46,93,9,0,0,-47,9,-39,5718,-1,8,16.2,1.6,0,-8.2,1.6,2
13265,13,32,22,19,0,-19,22,1,1609,-2,8.1,19.9,13.7,0,-11.8,13.7,8
13267,290,283,307,4111,-7,7,300,308,24296,1,12,11.7,12.7,-0.3,0.3,12.4,8
13269,69,129,48,232,9,-60,57,-4,7758,-1,8.9,16.6,6.2,1.2,-7.7,7.3,8
13271,126,177,-1455,1635,32,-51,-1423,-1458,10920,16,10.8,15.2,-124.9,2.7,-4.4,-122.2,9
13273,88,137,-25,296,1,-49,-24,-74,8718,-1,10.1,15.6,-2.9,0.1,-5.6,-2.7,3
13275,526,602,168,487,6,-76,174,98,45649,0,11.5,13.2,3.7,0.1,-1.7,3.8,4
13277,513,491,165,1014,29,22,194,219,41554,3,12.4,11.8,4,0.7,0.5,4.7,5
13279,384,382,168,540,56,2,224,227,27040,1,14.3,14.2,6.2,2.1,0.1,8.3,7
13281,99,226,196,570,5,-127,201,74,13035,0,7.6,17.4,15.1,0.4,-9.8,15.5,9
13283,79,97,2,482,0,-18,2,-18,6341,-2,12.4,15.3,0.3,0,-2.8,0.3,9
13285,920,795,283,1280,86,125,369,495,70742,1,13.1,11.3,4,1.2,1.8,5.2,4
13287,115,131,90,326,-1,-16,89,73,8909,0,13,14.8,10.1,-0.1,-1.8,10,9
13289,56,153,113,104,0,-97,113,15,7691,-1,7.3,19.9,14.7,0,-12.6,14.7,3
13291,175,399,932,527,28,-224,960,734,27124,-2,6.5,14.9,34.8,1,-8.4,35.9,8
13293,329,451,296,367,-5,-122,291,170,28263,1,11.7,16,10.5,-0.2,-4.3,10.3,6
13295,603,879,794,1293,7,-276,801,524,69489,-1,8.7,12.7,11.5,0.1,-4,11.6,2
13297,1146,1035,3455,912,89,111,3544,3638,106702,-17,10.9,9.9,32.9,0.8,1.1,33.8,1
13299,459,547,696,2264,34,-88,730,646,36243,4,12.8,15.2,19.4,0.9,-2.4,20.3,5
13301,51,84,-20,71,1,-33,-19,-51,5106,1,9.9,16.4,-3.9,0.2,-6.4,-3.7,8
13303,205,273,117,1888,3,-68,120,55,19820,3,10.4,13.8,5.9,0.2,-3.4,6.1,7
13305,339,442,696,1997,43,-103,739,636,31373,0,10.9,14.2,22.4,1.4,-3.3,23.8,6
13307,18,28,4,0,6,-10,10,0,2337,0,7.7,12,1.7,2.6,-4.3,4.3,8
13309,70,76,-225,2100,0,-6,-225,-229,7081,2,9.7,10.6,-31.3,0,-0.8,-31.3,9
13311,272,408,339,668,16,-136,355,222,29026,3,9.4,14.1,11.7,0.6,-4.7,12.3,8
13313,1204,979,197,959,170,225,367,592,103687,0,11.6,9.5,1.9,1.6,2.2,3.5,3
13315,83,146,93,2087,-2,-63,91,28,8779,0,9.5,16.7,10.6,-0.2,-7.2,10.4,9
13317,94,169,22,109,7,-75,29,-47,9518,-1,9.9,17.7,2.3,0.7,-7.9,3,8
13319,108,156,94,107,2,-48,96,48,8725,0,12.4,17.9,10.8,0.2,-5.5,11,8
13321,208,299,-67,174,-1,-91,-68,-158,20273,1,10.2,14.7,-3.3,0,-4.5,-3.3,3
15000,15167,12812,-11193,40128,4627,2355,-6566,-4261,1435138,-50,10.6,8.9,-7.8,3.2,1.6,-4.6,
15001,1945,2051,784,2683,583,-106,1367,1267,207615,6,9.4,9.9,3.8,2.8,-0.5,6.6,5
15003,10799,8770,-10794,34281,3399,2029,-7395,-5420,989408,-54,10.9,8.8,-10.9,3.4,2,-7.5,1
15005,0,0,0,18,0,0,0,0,81,0,0,0,0,0,0,0,3
15007,779,640,-247,918,175,139,-72,68,73851,1,10.6,8.7,-3.3,2.4,1.9,-1,5
15009,1644,1351,-936,2228,470,293,-466,-176,164183,-3,10,8.2,-5.7,2.9,1.8,-2.8,3
16000,22456,16817,15389,50256,4664,5639,20053,25730,1964726,38,11.5,8.6,7.9,2.4,2.9,10.3,
16001,5080,3781,2916,13711,1435,1299,4351,5669,524673,19,9.7,7.2,5.6,2.7,2.5,8.3,2
16003,28,53,136,29,1,-25,137,112,4903,0,5.8,10.9,28.1,0.2,-5.2,28.3,9
16005,1059,871,361,2343,223,188,584,775,90400,3,11.8,9.7,4,2.5,2.1,6.5,3
16007,77,68,10,59,17,9,27,36,6766,0,11.4,10.1,1.5,2.5,1.3,4,9
16009,104,150,124,66,1,-46,125,78,10369,-1,10.1,14.5,12,0.1,-4.5,12.1,8
16011,667,471,219,503,7,196,226,422,50395,0,13.3,9.4,4.4,0.1,3.9,4.5,6
16013,199,153,-174,383,269,46,95,140,25041,-1,8,6.1,-7,10.8,1.8,3.8,7
16015,68,84,106,19,66,-16,172,157,8517,1,8.1,10,12.6,7.8,-1.9,20.4,2
16017,448,549,1139,519,107,-101,1246,1140,52547,-5,8.6,10.6,21.9,2.1,-1.9,24,6
16019,1803,994,935,1671,69,809,1004,1823,131366,10,13.8,7.6,7.2,0.5,6.2,7.7,3
16021,151,153,215,119,73,-2,288,285,13557,-1,11.3,11.4,16,5.4,-0.1,21.5,9
16023,33,37,65,4,0,-4,65,60,2758,-1,12.1,13.6,23.8,0,-1.5,23.8,3
16025,11,6,58,0,0,5,58,63,1232,0,9.2,5,48.3,0,4.2,48.3,9
16027,3341,1970,4816,3234,584,1371,5400,6782,257674,11,13.1,7.7,18.9,2.3,5.4,21.2,2
16029,85,76,8,77,4,9,12,19,7219,-2,11.8,10.5,1.1,0.6,1.2,1.7,8
16031,366,228,-148,367,60,138,-88,52,25696,2,14.3,8.9,-5.8,2.3,5.4,-3.4,6
16033,19,5,-20,2,-1,14,-21,-9,801,-2,23.6,6.2,-24.8,-1.2,17.4,-26.1,8
16035,67,136,240,724,7,-69,247,179,9214,1,7.3,14.9,26.3,0.8,-7.6,27.1,8
16037,33,66,38,120,0,-33,38,5,4523,0,7.3,14.6,8.4,0,-7.3,8.4,8
16039,459,245,-53,1117,171,214,118,333,29724,1,15.5,8.3,-1.8,5.8,7.2,4,6
16041,216,124,230,94,2,92,232,324,15494,0,14.1,8.1,15,0.1,6,15.1,3
16043,186,143,112,581,25,43,137,179,14196,-1,13.2,10.1,7.9,1.8,3,9.7,8
16045,204,256,403,257,267,-52,670,617,21071,-1,9.8,12.3,19.4,12.9,-2.5,32.3,2
16047,226,166,108,107,13,60,121,182,16061,1,14.2,10.4,6.8,0.8,3.8,7.6,8
16049,170,228,299,503,16,-58,315,253,17890,-4,9.6,12.8,16.8,0.9,-3.3,17.7,8
16051,448,238,618,174,34,210,652,862,34198,0,13.3,7,18.3,1,6.2,19.3,3
16053,364,223,0,207,92,141,92,235,25479,2,14.4,8.8,0,3.6,5.6,3.6,3
16055,1879,1782,1613,1748,12,97,1625,1720,185010,-2,10.2,9.7,8.8,0.1,0.5,8.8,3
16057,431,295,-128,2676,368,136,240,377,41301,1,10.5,7.2,-3.1,9,3.3,5.8,4
16059,64,129,221,75,0,-65,221,157,8441,1,7.7,15.4,26.4,0,-7.8,26.4,9
16061,33,61,38,105,4,-28,42,14,3739,0,8.8,16.3,10.2,1.1,-7.5,11.3,8
16063,66,38,32,39,3,28,35,65,5450,2,12.2,7,5.9,0.6,5.2,6.5,8
16065,1110,210,-1703,14790,388,900,-1315,-411,54547,4,20.3,3.8,-31.1,7.1,16.4,-24,4
16067,304,212,168,77,10,92,178,272,22480,2,13.6,9.5,7.5,0.4,4.1,8,7
16069,395,591,212,1113,62,-196,274,78,42987,0,9.2,13.8,4.9,1.4,-4.6,6.4,3
16071,57,55,212,41,0,2,212,213,4953,-1,11.8,11.3,43.7,0,0.4,43.7,8
16073,148,137,60,156,6,11,66,77,12722,0,11.7,10.8,4.7,0.5,0.9,5.2,2
16075,326,302,335,180,-8,24,327,350,27279,-1,12,11.1,12.4,-0.3,0.9,12.1,6
16077,111,62,54,58,14,49,68,117,8253,0,13.5,7.6,6.6,1.7,6,8.3,8
16079,154,227,160,187,1,-73,161,91,14026,3,11,16.2,11.4,0.1,-5.2,11.5,8
16081,129,63,-51,23,16,66,-35,30,12549,-1,10.3,5,-4.1,1.3,5.3,-2.8,9
16083,1137,923,926,1711,194,214,1120,1335,95156,1,12,9.8,9.8,2.1,2.3,11.9,3
16085,84,96,208,143,-1,-12,207,194,12644,-1,6.7,7.7,16.6,-0.1,-1,16.5,9
16087,116,160,271,144,53,-44,324,278,11425,-2,10.3,14.2,24,4.7,-3.9,28.7,6
17000,127235,116782,-83839,278186,40492,10453,-43347,-32826,12549689,68,10.1,9.3,-6.7,3.2,0.8,-3.4,
17001,700,834,9,1625,9,-134,18,-115,64441,1,10.9,12.9,0.1,0.1,-2.1,0.3,5
17003,30,104,-73,82,0,-74,-73,-146,4695,1,6.3,21.8,-15.3,0,-15.5,-15.3,3
17005,130,203,-21,2371,8,-73,-13,-86,16450,0,7.9,12.3,-1.3,0.5,-4.4,-0.8,1
17007,512,485,114,265,-1,27,113,134,53202,-6,9.6,9.1,2.1,0,0.5,2.1,2
17009,56,61,-17,1720,0,-5,-17,-22,6294,0,8.9,9.7,-2.7,0,-0.8,-2.7,9
17011,319,425,-6,416,15,-106,9,-98,32729,-1,9.7,13,-0.2,0.5,-3.2,0.3,7
17013,27,82,19,85,0,-55,19,-36,4317,0,6.2,18.9,4.4,0,-12.7,4.4,1
17015,124,226,46,1234,3,-102,49,-53,15526,0,8,14.5,3,0.2,-6.6,3.2,9
17017,158,139,-128,127,67,19,-61,-42,12596,0,12.5,11,-10.1,5.3,1.5,-4.8,6
17019,2090,1504,-3275,15033,2144,586,-1131,-525,205644,20,10.2,7.3,-15.9,10.4,2.8,-5.5,3
17021,284,449,3,2912,0,-165,3,-162,33228,0,8.5,13.5,0.1,0,-5,0.1,6
17023,87,225,71,230,-4,-138,67,-72,15088,-1,5.8,14.9,4.7,-0.3,-9.1,4.4,8
17025,163,184,-58,278,0,-21,-58,-78,12999,1,12.5,14.1,-4.4,0,-1.6,-4.4,9
17027,375,368,-201,1757,38,7,-163,-152,36785,4,10.2,10,-5.5,1,0.2,-4.4,1
17029,449,566,-225,2705,52,-117,-173,-286,46060,4,9.7,12.3,-4.9,1.1,-2.5,-3.7,5
17031,53124,43149,-58105,82190,23790,9975,-34315,-24494,5087072,-154,10.4,8.5,-11.4,4.7,2,-6.7,1
17033,147,250,-94,1342,1,-103,-93,-195,18300,1,8,13.6,-5.1,0.1,-5.6,-5.1,6
17035,100,134,-14,98,2,-34,-12,-47,10261,-1,9.7,13,-1.4,0.2,-3.3,-1.2,9
17037,1040,818,-513,4827,350,222,-163,65,100288,6,10.4,8.2,-5.1,3.5,2.2,-1.6,1
17039,165,201,36,164,4,-36,40,0,15365,-4,10.7,13.1,2.3,0.3,-2.3,2.6,6
17041,243,239,-57,226,16,4,-41,-38,19629,-1,12.4,12.2,-2.9,0.8,0.2,-2.1,8
17043,9715,6667,-8099,13864,4517,3048,-3582,-451,921213,83,10.5,7.2,-8.8,4.9,3.3,-3.9,1
17045,112,259,96,367,2,-147,98,-51,16334,-2,6.8,15.8,5.9,0.1,-9,6,6
17047,28,88,-32,20,3,-60,-29,-90,5968,-1,4.7,14.6,-5.3,0.5,-10,-4.8,9
17049,374,391,10,405,37,-17,47,31,34331,1,10.9,11.4,0.3,1.1,-0.5,1.4,7
17051,188,252,-44,2423,1,-64,-43,-106,21164,1,8.9,11.9,-2.1,0,-3,-2,6
17053,144,210,25,307,33,-66,58,-6,13250,2,10.9,15.8,1.9,2.5,-5,4.4,3
17055,399,587,109,303,4,-188,113,-77,37138,-2,10.7,15.8,2.9,0.1,-5.1,3,7
17057,263,503,-156,1969,0,-240,-156,-394,32541,2,8,15.4,-4.8,0,-7.3,-4.8,6
17059,24,91,-86,86,1,-67,-85,-153,4670,-1,5.1,19.2,-18.1,0.2,-14.1,-17.9,8
17061,91,185,-2,111,0,-94,-2,-97,11543,-1,7.9,16,-0.2,0,-8.1,-0.2,8
17063,580,508,328,220,33,72,361,429,53578,-4,10.9,9.5,6.1,0.6,1.3,6.8,1
17065,73,105,-39,86,0,-32,-39,-70,7911,1,9.2,13.2,-4.9,0,-4,-4.9,9
17067,178,228,-22,178,5,-50,-17,-68,17186,-1,10.3,13.2,-1.3,0.3,-2.9,-1,9
17069,27,83,56,41,-1,-56,55,-3,3569,-2,7.6,23.2,15.7,-0.3,-15.7,15.4,9
17071,55,95,-40,40,1,-40,-39,-80,6088,-1,9,15.5,-6.5,0.2,-6.5,-6.4,9
17073,505,569,-82,736,-2,-64,-84,-148,48448,0,10.4,11.7,-1.7,0,-1.3,-1.7,2
17075,273,424,-209,387,2,-151,-207,-357,26136,1,10.4,16.1,-7.9,0.1,-5.7,-7.9,8
17077,542,569,-549,3061,237,-27,-312,-336,52141,3,10.4,10.9,-10.5,4.5,-0.5,-6,5
17079,83,121,2,120,8,-38,10,-28,9144,0,9.1,13.2,0.2,0.9,-4.1,1.1,9
17081,402,504,-5,1683,9,-102,4,-99,36320,-1,11.1,13.9,-0.1,0.2,-2.8,0.1,7
17083,151,292,28,706,14,-141,42,-100,21091,-1,7.1,13.8,1.3,0.7,-6.7,2,1
17085,143,280,45,207,5,-137,50,-89,21756,-2,6.6,12.8,2.1,0.2,-6.3,2.3,8
17087,101,168,-5,2455,6,-67,1,-65,13326,1,7.6,12.6,-0.4,0.4,-5,0.1,8
17089,5581,3707,-1805,5496,731,1874,-1074,843,514982,43,10.8,7.2,-3.5,1.4,3.6,-2.1,1
17091,1136,1243,-101,3876,147,-107,46,-58,105940,3,10.7,11.7,-1,1.4,-1,0.4,3
17093,1566,751,1440,370,235,815,1675,2482,139976,-8,11.3,5.4,10.4,1.7,5.9,12.1,1
17095,459,717,-120,3626,169,-258,49,-209,48411,0,9.5,14.8,-2.5,3.5,-5.3,1,4
17097,6534,4977,-5388,19964,2626,1557,-2762,-1139,708760,66,9.2,7,-7.6,3.7,2.2,-3.9,1
17099,1119,1328,261,2887,81,-209,342,128,108309,-5,10.3,12.3,2.4,0.7,-1.9,3.2,4
17101,90,194,24,2276,3,-104,27,-78,14813,-1,6.1,13.1,1.6,0.2,-7,1.8,9
17103,343,405,-243,2730,23,-62,-220,-284,33654,-2,10.1,12,-7.2,0.7,-1.8,-6.5,6
17105,383,480,-124,1808,23,-97,-101,-197,35320,1,10.8,13.6,-3.5,0.6,-2.7,-2.9,6
17107,254,342,0,3219,12,-88,12,-76,27590,0,9.2,12.4,0,0.4,-3.2,0.4,6
17109,233,319,-29,2491,42,-86,13,-75,26839,-2,8.7,11.9,-1.1,1.6,-3.2,0.5,7
17111,3060,2421,499,1852,114,639,613,1242,312800,-10,9.8,7.8,1.6,0.4,2,2,1
17113,1692,1356,-1426,8625,605,336,-821,-477,170441,8,9.9,7.9,-8.4,3.5,2,-4.8,3
17115,1149,1346,-715,3013,170,-197,-545,-742,100591,0,11.4,13.3,-7.1,1.7,-2,-5.4,3
17117,369,635,138,874,23,-266,161,-105,44018,0,8.4,14.4,3.1,0.5,-6,3.7,1
17119,2189,3108,-28,6718,122,-919,94,-820,262752,5,8.3,11.8,-0.1,0.5,-3.5,0.4,1
17121,421,560,-99,846,5,-139,-94,-232,36673,1,11.4,15.2,-2.7,0.1,-3.8,-2.6,7
17123,121,181,67,227,4,-60,71,12,11683,1,10.4,15.5,5.7,0.3,-5.1,6.1,2
17125,87,211,-55,180,4,-124,-51,-176,12523,-1,6.9,16.7,-4.4,0.3,-9.8,-4,8
17127,81,238,-2,255,-6,-157,-8,-166,13661,-1,5.9,17.3,-0.1,-0.4,-11.4,-0.6,3
17129,109,153,-78,95,2,-44,-76,-118,11954,2,9.1,12.7,-6.5,0.2,-3.7,-6.3,3
17131,137,207,25,134,1,-70,26,-46,15487,-2,8.8,13.3,1.6,0.1,-4.5,1.7,2
17133,134,347,172,281,0,-213,172,-44,34957,-3,3.8,9.9,4.9,0,-6.1,4.9,1
17135,235,392,-86,2354,4,-157,-82,-238,27663,1,8.5,14.1,-3.1,0.1,-5.7,-3,6
17137,327,448,-44,2467,7,-121,-37,-158,32140,0,10.1,13.9,-1.4,0.2,-3.8,-1.1,4
17139,162,204,3,402,6,-42,9,-33,14342,0,11.3,14.2,0.2,0.4,-2.9,0.6,8
17141,519,562,-52,495,17,-43,-35,-80,51265,-2,10.1,11,-1,0.3,-0.8,-0.7,6
17143,2008,1989,-1121,4726,608,19,-513,-487,177513,7,11.3,11.2,-6.3,3.4,0.1,-2.9,2
17145,177,277,87,2266,5,-100,92,-9,20503,-1,8.6,13.5,4.2,0.2,-4.9,4.5,7
17147,155,187,72,199,1,-32,73,39,16714,-2,9.3,11.2,4.3,0.1,-1.9,4.4,3
17149,158,233,-93,321,9,-75,-84,-157,14342,2,11,16.2,-6.4,0.6,-5.2,-5.8,9
17151,26,70,6,73,-1,-44,5,-39,3707,0,7,18.8,1.6,-0.3,-11.8,1.3,8
17153,37,107,32,160,-1,-70,31,-39,4911,0,7.5,21.7,6.5,-0.2,-14.2,6.3,8
17155,42,62,28,1,0,-20,28,8,5561,0,7.6,11.2,5,0,-3.6,5,8
17157,251,400,-113,2890,49,-149,-64,-211,29815,2,8.4,13.4,-3.8,1.6,-5,-2.1,6
17159,141,249,32,317,8,-108,40,-67,15488,1,9.1,16,2.1,0.5,-7,2.6,7
17161,1622,1663,-717,4397,436,-41,-281,-323,141236,-1,11.5,11.8,-5.1,3.1,-0.3,-2,2
17163,2168,2775,-877,4598,223,-607,-654,-1247,251018,14,8.6,11,-3.5,0.9,-2.4,-2.6,1
17165,230,380,-32,628,4,-150,-28,-179,22873,-1,10,16.5,-1.4,0.2,-6.5,-1.2,7
17167,1850,2074,-764,3689,319,-224,-445,-660,193491,9,9.5,10.7,-3.9,1.6,-1.2,-2.3,3
17169,66,100,4,595,11,-34,15,-20,6733,-1,9.8,14.8,0.6,1.6,-5,2.2,9
17171,34,68,-27,37,0,-34,-27,-61,4710,0,7.2,14.3,-5.7,0,-7.2,-5.7,9
17173,180,294,-34,175,5,-114,-29,-142,20568,1,8.7,14.2,-1.6,0.2,-5.5,-1.4,8
17175,44,86,-56,93,4,-42,-52,-95,5218,-1,8.4,16.3,-10.6,0.8,-8,-9.9,2
17177,314,623,-175,719,33,-309,-142,-451,43105,0,7.2,14.4,-4,0.8,-7.1,-3.3,4
17179,1201,1597,294,2475,36,-396,330,-69,129541,-3,9.3,12.3,2.3,0.3,-3.1,2.5,2
17181,136,253,-9,944,21,-117,12,-105,16667,0,8.1,15.1,-0.5,1.3,-7,0.7,6
17183,849,1115,-203,2690,16,-266,-187,-451,71652,2,11.8,15.5,-2.8,0.2,-3.7,-2.6,4
17185,39,161,15,336,10,-122,25,-98,10942,-1,3.5,14.6,1.4,0.9,-11.1,2.3,7
17187,196,210,-187,874,25,-14,-162,-175,16185,1,12,12.9,-11.5,1.5,-0.9,-10,6
17189,111,170,-29,217,1,-59,-28,-87,13536,0,8.2,12.5,-2.1,0.1,-4.3,-2.1,8
17191,137,252,-23,131,57,-115,34,-82,15761,-1,8.7,15.9,-1.5,3.6,-7.3,2.2,9
17193,86,243,-43,588,6,-157,-37,-194,13401,0,6.4,18,-3.2,0.4,-11.6,-2.7,6
17195,537,743,112,962,43,-206,155,-57,54498,-6,9.8,13.6,2.1,0.8,-3.8,2.8,4
17197,6953,5180,-374,9525,1289,1773,915,2682,700728,-6,9.9,7.4,-0.5,1.8,2.5,1.3,1
17199,633,854,322,2039,61,-221,383,162,66706,0,9.5,12.8,4.8,0.9,-3.3,5.7,5
17201,3193,3290,-1144,3595,608,-97,-536,-620,280922,13,11.4,11.7,-4.1,2.2,-0.3,-1.9,2
17203,397,420,104,903,27,-23,131,108,38285,0,10.4,11,2.7,0.7,-0.6,3.4,2
18000,79587,72079,4599,178474,17869,7508,22468,29925,6862199,-51,11.6,10.5,0.7,2.6,1.1,3.3,
18001,629,369,-124,482,-1,260,-125,137,36288,2,17.4,10.2,-3.4,0,7.2,-3.5,6
18003,5282,3520,103,6295,1020,1762,1123,2901,394545,16,13.4,9,0.3,2.6,4.5,2.9,2
18005,1031,820,-281,1247,673,211,392,609,84003,6,12.3,9.8,-3.4,8,2.5,4.7,3
18007,90,108,68,102,9,-18,77,57,8729,-2,10.3,12.4,7.8,1,-2.1,8.9,3
18009,130,202,43,136,5,-72,48,-26,11893,-2,10.9,17,3.6,0.4,-6,4,6
18011,879,609,1456,831,91,270,1547,1811,76120,-6,11.7,8.1,19.4,1.2,3.6,20.6,1
18013,94,199,168,135,5,-105,173,66,15653,-2,6,12.7,10.8,0.3,-6.7,11.1,1
18015,193,233,40,103,12,-40,52,11,20525,-1,9.4,11.4,1.9,0.6,-1.9,2.5,3
18017,474,464,-6,715,128,10,122,129,37666,-3,12.6,12.3,-0.2,3.4,0.3,3.2,4
18019,1309,1413,1230,1670,112,-104,1342,1245,125467,7,10.5,11.3,9.9,0.9,-0.8,10.7,1
18021,302,343,88,344,4,-41,92,50,26460,-1,11.4,13,3.3,0.2,-1.6,3.5,3
18023,395,416,-33,625,14,-21,-19,-39,32730,1,12.1,12.7,-1,0.4,-0.6,-0.6,6
18025,97,161,-13,69,-1,-64,-14,-79,10438,-1,9.3,15.4,-1.2,-0.1,-6.1,-1.3,8
18027,532,338,-151,647,112,194,-39,160,33656,5,15.8,10.1,-4.5,3.3,5.8,-1.2,7
18029,380,571,498,536,12,-191,510,315,51215,-4,7.4,11.2,9.8,0.2,-3.7,10,1
18031,309,334,-45,499,17,-25,-28,-55,26399,-2,11.7,12.6,-1.7,0.6,-0.9,-1.1,6
18033,544,474,305,418,11,70,316,385,44198,-1,12.4,10.8,6.9,0.2,1.6,7.2,4
18035,1124,1425,339,7886,121,-301,460,158,112321,-1,10,12.7,3,1.1,-2.7,4.1,3
18037,498,497,2,711,51,1,53,54,43546,0,11.4,11.4,0,1.2,0,1.2,5
18039,2878,1901,-1925,2427,475,977,-1450,-464,206409,9,13.9,9.2,-9.3,2.3,4.7,-7,3
18041,241,362,82,348,12,-121,94,-27,23362,0,10.3,15.5,3.5,0.5,-5.2,4,6
18043,703,879,277,1723,86,-176,363,188,80809,1,8.7,10.9,3.4,1.1,-2.2,4.5,1
18045,224,254,136,111,7,-30,143,111,16731,-2,13.4,15.2,8.2,0.4,-1.8,8.6,8
18047,198,256,55,155,19,-58,74,13,23096,-3,8.6,11.1,2.4,0.8,-2.5,3.2,1
18049,234,283,25,138,14,-49,39,-10,20358,0,11.5,13.9,1.2,0.7,-2.4,1.9,7
18051,373,385,-106,604,19,-12,-87,-98,32904,1,11.3,11.7,-3.2,0.6,-0.4,-2.6,6
18053,745,1038,386,4732,114,-293,500,207,66200,0,11.3,15.7,5.8,1.7,-4.4,7.6,4
18055,343,431,180,301,33,-88,213,125,31196,0,11,13.8,5.8,1.1,-2.8,6.8,6
18057,4009,2099,2719,2612,1568,1910,4287,6182,371645,-15,10.9,5.7,7.4,4.3,5.2,11.6,1
18059,872,851,2977,834,62,21,3039,3049,86166,-11,10.3,10.1,35.2,0.7,0.2,35.9,1
18061,382,497,313,474,20,-115,333,216,40006,-2,9.6,12.5,7.8,0.5,-2.9,8.3,1
18063,1841,1337,2382,3723,419,504,2801,3268,186387,-37,10,7.2,12.9,2.3,2.7,15.2,1
18065,420,679,374,3719,1,-259,375,114,48929,-2,8.6,13.9,7.7,0,-5.3,7.7,6
18067,947,1217,501,1164,58,-270,559,285,83831,-4,11.3,14.5,6,0.7,-3.2,6.7,3
18069,412,492,25,1245,37,-80,62,-19,36781,-1,11.2,13.4,0.7,1,-2.2,1.7,6
18071,598,529,-135,754,295,69,160,230,46460,1,12.9,11.4,-2.9,6.4,1.5,3.5,4
18073,384,412,215,190,4,-28,219,190,33535,-1,11.5,12.3,6.4,0.1,-0.8,6.5,1
18075,279,295,-80,253,9,-16,-71,-86,20032,1,13.9,14.7,-4,0.4,-0.8,-3.5,6
18077,347,417,157,2350,33,-70,190,120,33056,0,10.5,12.6,4.8,1,-2.1,5.8,6
18079,291,344,189,293,1,-53,190,138,27622,1,10.6,12.5,6.9,0,-1.9,6.9,6
18081,1886,1560,1606,2977,206,326,1812,2133,167819,-5,11.3,9.4,9.6,1.2,2,10.9,1
18083,411,471,171,1668,84,-60,255,194,36070,-1,11.4,13.1,4.8,2.3,-1.7,7.1,7
18085,903,850,-390,1531,133,53,-257,-200,80364,4,11.2,10.6,-4.8,1.7,0.7,-3.2,4
18087,668,305,-337,168,23,363,-314,53,40907,4,16.3,7.5,-8.2,0.6,8.9,-7.7,8
18089,5653,5407,-19,4316,708,246,689,941,500598,6,11.3,10.8,0,1.4,0.5,1.4,1
18091,1180,1274,-61,6366,35,-94,-26,-116,111706,4,10.6,11.4,-0.5,0.3,-0.8,-0.2,3
18093,502,674,13,598,14,-172,27,-147,45084,-2,11.1,14.9,0.3,0.3,-3.8,0.6,6
18095,1402,1757,1437,5766,37,-355,1474,1121,132504,2,10.6,13.3,10.9,0.3,-2.7,11.2,1
18097,13736,9122,-11403,16590,6055,4614,-5348,-763,968460,-29,14.2,9.4,-11.8,6.2,4.8,-5.5,1
18099,567,519,-108,672,34,48,-74,-26,46352,0,12.2,11.2,-2.3,0.7,1,-1.6,6
18101,144,127,56,156,-1,17,55,70,9897,-2,14.6,12.9,5.7,-0.1,1.7,5.6,9
18103,340,496,3,3360,9,-156,12,-144,35402,0,9.6,14,0.1,0.3,-4.4,0.3,6
18105,1146,1082,-1273,12239,913,64,-360,-279,139342,17,8.2,7.8,-9.1,6.5,0.5,-2.6,3
18107,445,461,249,1065,20,-16,269,254,38573,1,11.6,12,6.5,0.5,-0.4,7,6
18109,797,824,977,665,21,-27,998,967,73227,-4,11,11.3,13.4,0.3,-0.4,13.7,1
18111,152,219,164,141,25,-67,189,121,13960,-1,10.9,15.8,11.8,1.8,-4.8,13.6,1
18113,603,528,60,686,60,75,120,196,47430,1,12.7,11.2,1.3,1.3,1.6,2.5,6
18115,47,89,-54,38,2,-42,-52,-93,6004,1,7.8,14.7,-8.9,0.3,-6.9,-8.6,1
18117,213,304,129,262,2,-91,131,37,19638,-3,10.9,15.5,6.6,0.1,-4.6,6.7,8
18119,55,305,293,224,5,-250,298,45,21532,-3,2.6,14.2,13.6,0.2,-11.6,13.9,3
18121,209,192,101,1000,1,17,102,117,16484,-2,12.7,11.7,6.1,0.1,1,6.2,8
18123,164,239,53,1580,25,-75,78,2,19209,-1,8.5,12.4,2.8,1.3,-3.9,4.1,7
18125,130,185,22,174,-3,-55,19,-37,12106,-1,10.7,15.3,1.8,-0.2,-4.5,1.6,8
18127,1693,1729,347,3323,182,-36,529,487,175335,-6,9.7,9.9,2,1,-0.2,3,1
18129,205,245,-21,205,2,-40,-19,-58,25040,1,8.2,9.8,-0.8,0.1,-1.6,-0.8,2
18131,123,207,5,158,14,-84,19,-64,12385,1,9.9,16.7,0.4,1.1,-6.8,1.5,8
18133,350,414,291,4140,46,-64,337,273,37567,0,9.4,11.1,7.8,1.2,-1.7,9,6
18135,286,401,-40,252,21,-115,-19,-134,24216,0,11.8,16.5,-1.6,0.9,-4.7,-0.8,6
18137,334,404,262,531,9,-70,271,197,29227,-4,11.5,13.9,9,0.3,-2.4,9.3,6
18139,200,220,186,124,11,-20,197,175,16847,-2,11.9,13.1,11.1,0.7,-1.2,11.8,6
18141,3286,2826,-671,12627,763,460,92,566,272848,14,12.1,10.4,-2.5,2.8,1.7,0.3,2
18143,279,425,298,379,4,-146,302,157,24657,1,11.4,17.3,12.1,0.2,-5.9,12.3,6
18145,479,510,-14,734,86,-31,72,42,45231,1,10.6,11.3,-0.3,1.9,-0.7,1.6,1
18147,187,270,137,305,9,-83,146,61,19910,-2,9.4,13.6,6.9,0.5,-4.2,7.3,8
18149,236,363,115,100,15,-127,130,3,23206,0,10.2,15.6,5,0.6,-5.5,5.6,8
18151,356,375,145,1730,20,-19,165,145,34917,-1,10.2,10.8,4.2,0.6,-0.5,4.7,7
18153,212,270,140,2211,7,-58,147,86,20757,-3,10.2,13,6.8,0.3,-2.8,7.1,3
18155,111,118,17,100,0,-7,17,10,10019,0,11.1,11.8,1.7,0,-0.7,1.7,8
18157,2028,1367,-2049,15916,1925,661,-124,555,188792,18,10.8,7.3,-10.9,10.2,3.5,-0.7,3
18159,148,223,0,198,6,-75,6,-69,15256,0,9.7,14.6,0,0.4,-4.9,0.4,1
18161,62,90,33,35,1,-28,34,6,6973,0,8.9,12.9,4.7,0.1,-4,4.9,8
18163,2159,2108,-3,6742,196,51,193,247,179810,3,12,11.7,0,1.1,0.3,1.1,2
18165,171,227,35,188,4,-56,39,-16,15417,1,11.1,14.7,2.3,0.3,-3.6,2.5,3
18167,1167,1226,-34,8907,161,-59,127,71,106153,3,11,11.6,-0.3,1.5,-0.6,1.2,3
18169,313,504,8,1198,11,-191,19,-172,30670,0,10.2,16.4,0.3,0.4,-6.2,0.6,6
18171,87,95,35,79,4,-8,39,30,8518,-1,10.2,11.2,4.1,0.5,-0.9,4.6,3
18173,584,673,659,937,73,-89,732,636,65867,-7,8.9,10.3,10.1,1.1,-1.4,11.2,2
18175,303,381,100,337,12,-78,112,34,28205,0,10.7,13.5,3.5,0.4,-2.8,4,1
18177,748,943,23,2152,83,-195,106,-89,66127,0,11.3,14.3,0.3,1.3,-2.9,1.6,5
18179,314,347,266,464,24,-33,290,257,28555,0,11,12.2,9.4,0.8,-1.2,10.2,2
18181,423,311,60,224,85,112,145,257,24917,0,17.1,12.5,2.4,3.4,4.5,5.8,6
18183,377,363,146,335,6,14,152,165,34742,-1,10.9,10.5,4.2,0.2,0.4,4.4,2
19000,36898,33119,-3603,97595,7112,3779,3509,7311,3207004,23,11.5,10.3,-1.1,2.2,1.2,1.1,
19001,85,120,-37,162,4,-35,-33,-68,7389,0,11.5,16.2,-5,0.5,-4.7,-4.4,8
19003,39,56,-40,71,1,-17,-39,-57,3544,-1,10.9,15.7,-11.2,0.3,-4.8,-10.9,9
19005,177,155,-27,200,61,22,34,56,14074,0,12.6,11,-1.9,4.3,1.6,2.4,8
19007,126,190,41,239,3,-64,44,-22,12119,-2,10.4,15.7,3.4,0.2,-5.3,3.6,7
19009,61,83,-25,98,7,-22,-18,-41,5534,-1,11,14.9,-4.5,1.3,-4,-3.2,9
19011,263,247,26,331,13,16,39,54,25796,-1,10.2,9.6,1,0.5,0.6,1.5,2
19013,1629,1352,-226,4366,370,277,144,419,130471,-2,12.5,10.4,-1.7,2.8,2.1,1.1,3
19015,281,350,83,755,-1,-69,82,11,26590,-2,10.6,13.2,3.1,0,-2.6,3.1,3
19017,250,256,37,1573,24,-6,61,53,25307,-2,9.9,10.1,1.5,0.9,-0.2,2.4,3
19019,254,223,-59,110,29,31,-30,2,20691,1,12.3,10.8,-2.9,1.4,1.5,-1.4,6
19021,304,181,-323,792,122,123,-201,-77,20567,1,14.8,8.8,-15.7,5.9,6,-9.8,7
19023,152,192,-42,222,9,-40,-33,-74,14172,-1,10.7,13.5,-3,0.6,-2.8,-2.3,8
19025,94,141,86,694,2,-47,88,38,9763,-3,9.6,14.5,8.8,0.2,-4.8,9,9
19027,250,286,-9,472,26,-36,17,-19,20522,0,12.2,13.9,-0.4,1.3,-1.8,0.8,7
19029,129,200,66,191,0,-71,66,-7,13130,-2,9.8,15.2,5,0,-5.4,5,6
19031,160,227,5,264,10,-67,15,-51,18302,1,8.7,12.4,0.3,0.5,-3.7,0.8,8
19033,449,546,47,1010,30,-97,77,-20,42406,0,10.6,12.9,1.1,0.7,-2.3,1.8,5
19035,125,174,167,407,-1,-49,166,115,11605,-2,10.8,15.1,14.5,-0.1,-4.2,14.4,9
19037,132,147,-92,208,36,-15,-56,-70,11658,1,11.3,12.6,-7.9,3.1,-1.3,-4.8,8
19039,127,154,-41,153,12,-27,-29,-55,9588,1,13.2,16,-4.3,1.2,-2.8,-3,6
19041,165,190,27,267,2,-25,29,4,16511,0,10,11.5,1.6,0.1,-1.5,1.8,7
19043,168,222,-49,298,15,-54,-34,-88,16969,0,9.9,13,-2.9,0.9,-3.2,-2,8
19045,549,618,-32,636,5,-69,-27,-97,46158,-1,11.9,13.4,-0.7,0.1,-1.5,-0.6,4
19047,228,161,-223,485,40,67,-183,-116,16013,0,14.2,10,-13.9,2.5,4.2,-11.4,7
19049,1413,599,1908,715,218,814,2126,2946,111092,6,12.9,5.5,17.4,2,7.4,19.4,2
19051,154,88,-76,81,32,66,-44,22,9169,0,16.8,9.6,-8.3,3.5,7.2,-4.8,9
19053,86,98,-26,480,9,-12,-17,-30,7665,-1,11.2,12.8,-3.4,1.2,-1.6,-2.2,9
19055,201,186,-24,241,3,15,-21,-7,17600,-1,11.4,10.6,-1.4,0.2,0.9,-1.2,8
19057,415,509,64,531,41,-94,105,11,38253,0,10.9,13.3,1.7,1.1,-2.5,2.7,5
19059,154,208,56,319,7,-54,63,8,18056,-1,8.5,11.5,3.1,0.4,-3,3.5,7
19061,1115,1018,-31,4226,105,97,74,172,98887,1,11.3,10.3,-0.3,1.1,1,0.7,3
19063,95,124,49,376,-4,-29,45,15,9229,-1,10.3,13.4,5.3,-0.4,-3.1,4.9,7
19065,205,262,-11,872,13,-57,2,-56,19210,-1,10.7,13.6,-0.6,0.7,-3,0.1,6
19067,164,204,15,215,4,-40,19,-22,15326,-1,10.7,13.3,1,0.3,-2.6,1.2,7
19069,130,122,-92,166,13,8,-79,-71,9875,0,13.1,12.3,-9.3,1.3,0.8,-8,9
19071,67,95,9,98,1,-28,10,-17,6458,1,10.4,14.7,1.4,0.2,-4.3,1.5,8
19073,89,129,-86,109,1,-40,-85,-126,8584,-1,10.3,14.9,-9.9,0.1,-4.6,-9.8,8
19075,141,149,32,154,6,-8,38,29,12384,-1,11.4,12,2.6,0.5,-0.6,3.1,3
19077,95,133,70,96,11,-38,81,41,10722,-2,8.9,12.4,6.5,1,-3.6,7.6,2
19079,181,194,-77,245,15,-13,-62,-74,14729,1,12.3,13.1,-5.2,1,-0.9,-4.2,6
19081,120,149,-22,192,15,-29,-7,-36,10615,0,11.3,14,-2.1,1.4,-2.7,-0.7,9
19083,154,252,-130,715,76,-98,-54,-151,16463,1,9.3,15.2,-7.9,4.6,-5.9,-3.3,6
19085,157,185,17,260,1,-28,18,-10,14670,0,10.7,12.6,1.2,0.1,-1.9,1.2,2
19087,194,243,-667,1516,4,-49,-663,-706,19547,6,9.7,12.2,-33.5,0.2,-2.5,-33.3,6
19089,127,131,-133,113,6,-4,-127,-133,9376,-2,13.4,13.9,-14.1,0.6,-0.4,-13.4,8
19091,124,120,-47,82,22,4,-25,-21,9500,0,13,12.6,-4.9,2.3,0.4,-2.6,7
19093,79,97,-56,168,3,-18,-53,-72,6833,-1,11.5,14.1,-8.2,0.4,-2.6,-7.7,8
19095,185,210,-90,349,-2,-25,-92,-116,16381,1,11.3,12.8,-5.5,-0.1,-1.5,-5.6,8
19097,208,237,13,187,13,-29,26,-4,19342,-1,10.8,12.3,0.7,0.7,-1.5,1.3,6
19099,383,424,-36,1922,47,-41,11,-30,37919,0,10.1,11.2,-0.9,1.2,-1.1,0.3,2
19101,144,189,-311,797,128,-45,-183,-228,15440,0,9.3,12.2,-20,8.2,-2.9,-11.8,7
19103,1690,877,-934,10189,729,813,-205,613,157528,5,10.7,5.6,-5.9,4.6,5.2,-1.3,3
19105,192,227,-14,1622,0,-35,-14,-49,20900,0,9.2,10.8,-0.7,0,-1.7,-0.7,2
19107,109,138,53,117,7,-29,60,31,9914,0,11,13.9,5.4,0.7,-2.9,6.1,8
19109,164,194,-48,309,8,-30,-40,-69,14396,1,11.4,13.4,-3.3,0.6,-2.1,-2.8,7
19111,338,485,-114,1151,-5,-147,-119,-264,32565,2,10.3,14.8,-3.5,-0.2,-4.5,-3.6,7
19113,2621,2063,-1020,5476,484,558,-536,32,228972,10,11.4,9,-4.5,2.1,2.4,-2.3,2
19115,113,120,-149,96,52,-7,-97,-104,10513,0,10.7,11.4,-14.1,4.9,-0.7,-9.2,8
19117,115,124,50,63,4,-9,54,45,8747,0,13.2,14.2,5.7,0.5,-1,6.2,8
19119,158,96,63,179,23,62,86,147,12324,-1,12.9,7.8,5.1,1.9,5.1,7,8
19121,194,169,-96,63,1,25,-95,-69,16971,1,11.4,9.9,-5.6,0.1,1.5,-5.6,2
19123,232,266,-82,788,18,-34,-64,-97,21874,1,10.6,12.1,-3.7,0.8,-1.6,-2.9,7
19125,357,374,157,1440,3,-17,160,140,33770,-3,10.6,11.1,4.7,0.1,-0.5,4.7,6
19127,479,537,-33,1058,283,-58,250,193,40014,1,12,13.5,-0.8,7.1,-1.5,6.3,4
19129,123,160,124,287,13,-37,137,98,14633,-2,8.4,11,8.5,0.9,-2.5,9.4,2
19131,127,146,-36,252,29,-19,-7,-26,10518,0,12.1,13.9,-3.4,2.8,-1.8,-0.7,9
19133,92,150,40,152,6,-58,46,-13,8493,-1,10.8,17.6,4.7,0.7,-6.8,5.4,8
19135,83,111,2,92,0,-28,2,-26,7504,0,11,14.8,0.3,0,-3.7,0.3,9
19137,98,157,-13,201,2,-59,-11,-71,10139,-1,9.6,15.4,-1.3,0.2,-5.8,-1.1,6
19139,467,468,-281,719,106,-1,-175,-177,42218,-1,11,11.1,-6.6,2.5,0,-4.1,4
19141,185,183,-116,456,42,2,-74,-73,14012,-1,13.2,13,-8.3,3,0.1,-5.3,7
19143,60,84,-80,107,12,-24,-68,-94,5978,-2,10,13.9,-13.3,2,-4,-11.3,9
19145,136,215,-88,1287,5,-79,-83,-162,15014,0,9,14.2,-5.8,0.3,-5.2,-5.5,6
19147,113,134,41,343,0,-21,41,20,8810,0,12.8,15.2,4.7,0,-2.4,4.7,9
19149,306,264,-89,319,47,42,-42,0,25722,0,11.9,10.3,-3.5,1.8,1.6,-1.6,6
19151,77,103,-98,113,27,-26,-71,-97,6976,0,11,14.7,-14,3.8,-3.7,-10.1,9
19153,6560,4143,63,8956,1579,2417,1642,4071,505255,12,13,8.2,0.1,3.1,4.8,3.3,2
19155,946,1079,42,2203,203,-133,245,114,93179,2,10.2,11.6,0.5,2.2,-1.4,2.6,2
19157,190,234,-38,1610,18,-44,-20,-65,18453,-1,10.3,12.7,-2.1,1,-2.4,-1.1,6
19159,43,81,-9,117,1,-38,-8,-46,4642,0,9.2,17.4,-1.9,0.2,-8.1,-1.7,9
19161,112,149,32,156,2,-37,34,-3,9686,0,11.6,15.4,3.3,0.2,-3.8,3.5,9
19163,1904,1722,35,3122,302,182,337,519,174270,0,10.9,9.9,0.2,1.7,1,1.9,2
19165,113,152,77,193,59,-39,136,95,11806,-2,9.6,12.9,6.5,5,-3.3,11.6,8
19167,508,267,-245,2434,119,241,-126,119,36246,4,14,7.4,-6.8,3.3,6.7,-3.5,6
19169,840,625,-380,10563,468,215,88,309,98566,6,8.5,6.4,-3.9,4.8,2.2,0.9,3
19171,203,213,-133,267,31,-10,-102,-110,16833,2,12,12.6,-7.9,1.8,-0.6,-6,6
19173,75,86,42,69,19,-11,61,49,5924,-1,12.7,14.6,7.1,3.2,-1.9,10.3,9
19175,104,170,13,340,59,-66,72,3,11906,-3,8.7,14.3,1.1,5,-5.5,6,6
19177,100,93,7,83,1,7,8,14,7266,-1,13.8,12.8,1,0.1,1,1.1,9
19179,453,471,-35,974,140,-18,105,85,35166,-2,12.9,13.4,-1,4,-0.5,3,5
19181,617,514,780,1641,22,103,802,902,55205,-3,11.3,9.4,14.2,0.4,1.9,14.6,2
19183,278,263,-27,342,30,15,3,18,22560,0,12.3,11.7,-1.2,1.3,0.7,0.1,3
19185,88,84,63,86,0,4,63,67,6557,0,13.5,12.9,9.7,0,0.6,9.7,9
19187,409,476,-210,3090,107,-67,-103,-167,36485,3,11.2,13,-5.7,2.9,-1.8,-2.8,5
19189,96,125,-42,561,5,-29,-37,-68,10571,-2,9.1,11.8,-4,0.5,-2.7,-3.5,9
19191,179,210,-66,1592,7,-31,-59,-87,19815,3,9,10.6,-3.3,0.4,-1.6,-3,7
19193,1426,1017,-375,2859,352,409,-23,393,105951,7,13.5,9.6,-3.5,3.3,3.9,-0.2,3
19195,79,93,-4,67,3,-14,-1,-14,7297,1,10.8,12.7,-0.5,0.4,-1.9,-0.1,9
19197,169,181,-110,162,82,-12,-28,-39,12656,1,13.3,14.3,-8.7,6.5,-0.9,-2.2,9
2000,9266,5581,-5543,29815,2004,3685,-3539,130,733406,-16,12.6,7.6,-7.6,2.7,5,-4.8,
20000,34768,30329,-4574,87026,3932,4439,-642,3830,2940546,33,11.8,10.3,-1.6,1.3,1.5,-0.2,
20001,124,196,-6,385,2,-72,-4,-77,12412,-1,10,15.7,-0.5,0.2,-5.8,-0.3,7
20003,102,104,43,88,0,-2,43,40,7838,-1,13,13.3,5.5,0,-0.3,5.5,8
20005,172,218,7,1694,1,-46,8,-37,16016,1,10.7,13.6,0.4,0.1,-2.9,0.5,6
20007,40,67,-26,41,0,-27,-26,-53,4071,0,9.8,16.4,-6.3,0,-6.6,-6.3,9
20009,314,351,-135,537,12,-37,-123,-159,24899,1,12.6,14.1,-5.4,0.5,-1.5,-4.9,7
20011,193,210,-17,386,-1,-17,-18,-35,14408,0,13.4,14.6,-1.2,-0.1,-1.2,-1.2,6
20013,113,156,-80,120,0,-43,-80,-123,9250,0,12.1,16.8,-8.6,0,-4.6,-8.6,8
20015,747,734,249,2625,85,13,334,343,68632,-4,10.9,10.7,3.6,1.2,0.2,4.9,2
20017,36,32,6,176,0,4,6,11,2579,1,14,12.4,2.3,0,1.6,2.3,8
20019,23,65,1,83,0,-42,1,-40,3347,1,6.8,19.3,0.3,0,-12.5,0.3,9
20021,166,301,169,166,-2,-135,167,29,19054,-3,8.7,15.8,8.9,-0.1,-7.1,8.8,3
20023,40,39,19,29,-1,1,18,18,2636,-1,15.2,14.8,7.2,-0.4,0.4,6.9,9
20025,21,32,-79,32,0,-11,-79,-92,1847,-2,11.1,16.9,-41.7,0,-5.8,-41.7,9
20027,81,112,-3,199,0,-31,-3,-34,8007,0,10.1,14,-0.4,0,-3.9,-0.4,8
20029,110,156,-42,551,8,-46,-34,-80,8854,0,12.4,17.5,-4.7,0.9,-5.2,-3.8,7
20031,71,108,28,110,8,-37,36,-1,8251,0,8.6,13.1,3.4,1,-4.5,4.4,8
20033,17,31,-20,42,0,-14,-20,-35,1655,-1,10.2,18.5,-12,0,-8.4,-12,9
20035,414,493,-201,1950,11,-79,-190,-266,34157,3,12.1,14.4,-5.9,0.3,-2.3,-5.5,4
20037,449,495,-358,1480,20,-46,-338,-381,38764,3,11.5,12.7,-9.2,0.5,-1.2,-8.7,4
20039,27,58,55,44,1,-31,56,23,2712,-2,10,21.5,20.4,0.4,-11.5,20.7,9
20041,190,278,180,252,0,-88,180,90,18445,-2,10.3,15.1,9.8,0,-4.8,9.8,6
20043,74,109,46,385,6,-35,52,18,7493,1,9.9,14.6,6.1,0.8,-4.7,6.9,3
20045,1069,796,-55,8534,322,273,267,546,120553,6,8.9,6.6,-0.5,2.7,2.3,2.2,3
20047,29,59,-5,35,6,-30,1,-27,2733,2,10.6,21.5,-1.8,2.2,-10.9,0.4,9
20049,19,50,50,4,0,-31,50,19,2467,0,7.7,20.3,20.3,0,-12.6,20.3,8
20051,269,228,-84,1836,11,41,-73,-30,28810,2,9.3,7.9,-2.9,0.4,1.4,-2.5,5
20053,56,84,2,1166,0,-28,2,-26,6357,0,8.8,13.2,0.3,0,-4.4,0.3,9
20055,560,320,-528,559,113,240,-415,-173,37466,2,14.9,8.5,-14.1,3,6.4,-11.1,5
20057,602,276,-346,668,70,326,-276,56,33980,6,17.7,8.1,-10.2,2.1,9.6,-8.1,5
20059,283,330,209,525,4,-47,213,166,26125,0,10.9,12.7,8,0.2,-1.8,8.2,6
20061,946,271,-1252,906,104,675,-1148,-482,35047,-9,26.8,7.7,-35.5,2.9,19.1,-32.5,3
20063,34,42,0,44,1,-8,1,-7,2735,0,12.4,15.3,0,0.4,-2.9,0.4,9
20065,28,41,-8,34,0,-13,-8,-21,2376,0,11.7,17.2,-3.4,0,-5.4,-3.4,9
20067,116,61,-174,55,15,55,-159,-103,7147,1,16.1,8.5,-24.2,2.1,7.6,-22.1,7
20069,84,64,7,82,6,20,13,32,5743,-1,14.7,11.2,1.2,1,3.5,2.3,9
20071,17,26,-41,24,0,-9,-41,-51,1181,-1,14.1,21.5,-34,0,-7.5,-34,9
20073,52,122,30,90,3,-70,33,-38,5870,-1,8.8,20.7,5.1,0.5,-11.9,5.6,8
20075,45,26,-48,0,16,19,-32,-15,2437,-2,18.4,10.6,-19.6,6.5,7.8,-13.1,9
20077,80,79,35,101,-1,1,34,35,5435,0,14.8,14.6,6.5,-0.2,0.2,6.3,8
20079,348,500,-17,1128,2,-152,-15,-167,33504,0,10.4,14.9,-0.5,0.1,-4.5,-0.4,2
20081,59,35,11,44,2,24,13,35,3630,-2,16.3,9.7,3,0.6,6.6,3.6,9
20083,11,42,-12,18,1,-31,-11,-42,1655,0,6.6,25.1,-7.2,0.6,-18.5,-6.6,9
20085,184,156,31,193,17,28,48,76,13368,0,13.8,11.7,2.3,1.3,2.1,3.6,3
20087,167,203,7,179,1,-36,8,-27,18327,1,9.1,11.1,0.4,0.1,-2,0.4,3
20089,29,59,-9,15,1,-30,-8,-38,2847,0,10.1,20.6,-3.1,0.3,-10.5,-2.8,9
20091,6982,4443,-450,5717,1030,2539,580,3146,622237,27,11.2,7.2,-0.7,1.7,4.1,0.9,1
20093,74,48,-68,69,-1,26,-69,-42,3823,1,19.3,12.5,-17.7,-0.3,6.8,-18,9
20095,77,260,75,111,0,-183,75,-108,7066,0,10.8,36.5,10.5,0,-25.7,10.5,8
20097,29,38,-30,166,7,-9,-23,-31,2374,1,12.1,15.9,-12.6,2.9,-3.8,-9.6,9
20099,207,290,106,415,4,-83,110,26,19728,-1,10.5,14.7,5.4,0.2,-4.2,5.6,7
20101,18,32,-1,16,0,-14,-1,-15,1529,0,11.7,20.8,-0.7,0,-9.1,-0.7,9
20103,896,747,411,6060,41,149,452,596,83518,-5,10.8,9,4.9,0.5,1.8,5.4,1
20105,29,42,24,38,0,-13,24,9,2920,-2,9.9,14.4,8.2,0,-4.5,8.2,9
20107,89,165,159,14,1,-76,160,83,9860,-1,9.1,16.8,16.2,0.1,-7.7,16.3,1
20109,35,49,-26,22,1,-14,-25,-38,2665,1,13,18.3,-9.7,0.4,-5.2,-9.3,9
20111,370,314,-20,1237,105,56,85,141,32172,0,11.5,9.8,-0.6,3.3,1.7,2.6,4
20113,329,395,91,1925,5,-66,96,28,30091,-2,10.9,13.1,3,0.2,-2.2,3.2,7
20115,115,213,4,622,2,-98,6,-93,11690,-1,9.8,18.1,0.3,0.2,-8.4,0.5,8
20117,97,133,-23,167,0,-36,-23,-59,9933,0,9.7,13.4,-2.3,0,-3.6,-2.3,8
20119,49,59,3,70,5,-10,8,-2,3911,0,12.5,15.1,0.8,1.3,-2.6,2,9
20121,365,405,559,472,11,-40,570,529,35320,-1,10.4,11.6,15.9,0.3,-1.1,16.3,1
20123,69,96,17,123,0,-27,17,-11,5719,-1,12.1,16.8,3,0,-4.7,3,9
20125,304,518,-81,762,9,-214,-72,-285,30568,1,9.9,16.9,-2.6,0.3,-7,-2.3,7
20127,53,71,-52,76,4,-18,-48,-66,5334,0,9.9,13.2,-9.7,0.7,-3.4,-8.9,8
20129,31,44,-12,54,5,-13,-7,-21,2580,-1,12,17,-4.6,1.9,-5,-2.7,9
2013,17,10,-53,2216,77,7,24,31,3461,0,4.9,2.9,-15.4,22.3,2,7,9
20131,130,120,-63,259,1,10,-62,-50,10114,2,12.8,11.8,-6.2,0.1,1,-6.1,9
20133,188,239,-122,441,10,-51,-112,-163,15420,0,12.1,15.4,-7.9,0.6,-3.3,-7.2,7
20135,33,53,-25,82,5,-20,-20,-39,2618,1,12.5,20.1,-9.5,1.9,-7.6,-7.6,9
20137,48,53,5,954,4,-5,9,5,5330,1,9,9.9,0.9,0.8,-0.9,1.7,9
20139,163,232,192,150,0,-69,192,119,15824,-4,10.3,14.7,12.2,0,-4.4,12.2,3
20141,36,57,-34,95,0,-21,-34,-54,3427,1,10.4,16.5,-9.8,0,-6.1,-9.8,9
20143,66,74,21,106,0,-8,21,12,5818,-1,11.4,12.7,3.6,0,-1.4,3.6,9
20145,63,86,-39,748,0,-23,-39,-62,6126,0,10.2,14,-6.3,0,-3.7,-6.3,9
20147,54,76,-1,50,1,-22,0,-22,4761,0,11.3,15.9,-0.2,0.2,-4.6,0,9
20149,375,217,-82,330,13,158,-69,90,26382,1,14.2,8.2,-3.1,0.5,6,-2.6,3
20151,115,128,22,497,1,-13,23,9,9082,-1,12.7,14.1,2.4,0.1,-1.4,2.5,7
20153,20,39,-40,37,0,-19,-40,-60,2463,-1,8,15.6,-16,0,-7.6,-16,9
20155,662,777,41,2816,19,-115,60,-55,61497,0,10.8,12.6,0.7,0.3,-1.9,1,4
20157,56,88,5,57,1,-32,6,-26,4627,0,12.1,19,1.1,0.2,-6.9,1.3,9
20159,105,142,-80,489,7,-37,-73,-110,9260,0,11.3,15.2,-8.6,0.8,-4,-7.8,9
2016,25,16,-67,2931,131,9,64,70,5160,-3,4.9,3.1,-13.1,25.6,1.8,12.5,9
20161,744,421,-800,11287,308,323,-492,-161,71402,8,10.4,5.9,-11.2,4.3,4.5,-6.9,3
20163,56,73,-16,190,1,-17,-15,-32,4778,0,11.7,15.2,-3.3,0.2,-3.5,-3.1,9
20165,28,56,-84,73,1,-28,-83,-111,2830,0,9.7,19.4,-29.1,0.3,-9.7,-28.8,9
20167,67,83,3,92,4,-16,7,-10,6723,-1,10,12.3,0.4,0.6,-2.4,1,9
20169,606,689,-272,1562,63,-83,-209,-291,53098,1,11.4,12.9,-5.1,1.2,-1.6,-3.9,5
20171,72,72,-82,75,-4,0,-86,-85,4922,1,14.5,14.5,-16.5,-0.8,0,-17.3,9
20173,6615,5110,889,11138,682,1505,1571,3101,528469,25,12.6,9.7,1.7,1.3,2.9,3,2
20175,393,164,-504,342,-3,229,-507,-278,21067,0,18.5,7.7,-23.8,-0.1,10.8,-23.9,7
20177,1990,1994,156,4603,54,-4,210,209,177746,3,11.2,11.2,0.9,0.3,0,1.2,3
20179,28,41,-2,37,0,-13,-2,-16,2423,-1,11.5,16.9,-0.8,0,-5.3,-0.8,9
20181,81,62,-49,252,-4,19,-53,-32,5844,2,13.8,10.6,-8.4,-0.7,3.2,-9,9
20183,42,52,27,53,0,-10,27,18,3590,1,11.7,14.5,7.5,0,-2.8,7.5,9
20185,44,81,-22,88,-2,-37,-24,-62,3909,-1,11.2,20.6,-5.6,-0.5,-9.4,-6.1,9
20187,15,19,-58,26,-3,-4,-61,-66,1901,-1,7.8,9.8,-30,-1.6,-2.1,-31.5,9
20189,65,55,-96,75,-4,10,-100,-89,5077,1,12.7,10.7,-18.7,-0.8,2,-19.5,9
20191,220,309,69,300,-3,-89,66,-25,22334,-2,9.8,13.8,3.1,-0.1,-4,3,2
20193,120,72,-98,380,7,48,-91,-43,7865,0,15.2,9.1,-12.4,0.9,6.1,-11.5,7
20195,28,43,-1,35,2,-15,1,-15,2731,-1,10.2,15.7,-0.4,0.7,-5.5,0.4,9
20197,88,89,47,188,3,-1,50,48,7057,-1,12.5,12.7,6.7,0.4,-0.1,7.1,3
20199,28,19,7,24,0,9,7,16,1509,0,18.7,12.7,4.7,0,6,4.7,9
2020,3573,2177,-3412,8916,1115,1396,-2297,-908,286075,-7,12.5,7.6,-11.9,3.9,4.9,-8,2
20201,67,79,21,103,2,-12,23,11,5504,0,12.2,14.4,3.8,0.4,-2.2,4.2,9
20203,40,30,-11,24,4,10,-7,4,2082,1,19.2,14.4,-5.3,1.9,4.8,-3.4,9
20205,76,152,-96,154,0,-76,-96,-172,8382,0,9,17.9,-11.3,0,-9,-11.3,9
20207,25,54,27,43,0,-29,27,-2,3115,0,8,17.3,8.7,0,-9.3,8.7,9
20209,2287,1552,-1754,3020,689,735,-1065,-345,165281,-15,13.8,9.4,-10.6,4.2,4.4,-6.4,1
2050,389,155,-276,486,5,234,-271,-35,18224,2,21.3,8.5,-15.1,0.3,12.8,-14.9,7
2060,11,7,-34,27,6,4,-28,-26,844,-2,12.8,8.2,-39.7,7,4.7,-32.7,9
2063,62,24,-183,273,15,38,-168,-130,6769,0,9.1,3.5,-26.8,2.2,5.6,-24.6,9
2066,32,18,53,25,-1,14,52,65,2674,-1,12.1,6.8,20.1,-0.4,5.3,19.7,9
2068,20,9,-9,23,6,11,-3,9,1584,1,12.7,5.7,-5.7,3.8,7,-1.9,9
2070,75,47,-156,42,12,28,-144,-117,4607,-1,16.1,10.1,-33.4,2.6,6,-30.9,9
2090,1427,606,-1391,3297,214,821,-1177,-362,94840,-6,15,6.4,-14.6,2.3,8.6,-12.4,3
2100,24,17,-12,22,6,7,-6,0,2070,-1,11.6,8.2,-5.8,2.9,3.4,-2.9,9
21000,52380,54385,8965,121207,7627,-2005,16592,14591,4526154,4,11.6,12,2,1.7,-0.4,3.7,
21001,197,265,217,1158,18,-68,235,167,19264,0,10.3,13.8,11.3,0.9,-3.5,12.3,7
21003,268,277,519,168,-5,-9,514,505,21788,0,12.4,12.9,24.1,-0.2,-0.4,23.9,3
21005,249,270,353,91,7,-21,360,340,24613,1,10.2,11,14.4,0.3,-0.9,14.7,6
21007,59,128,11,114,-1,-69,10,-60,7582,-1,7.8,16.8,1.4,-0.1,-9.1,1.3,3
21009,548,594,159,634,23,-46,182,136,45008,0,12.2,13.2,3.5,0.5,-1,4,6
21011,175,213,185,88,0,-38,185,147,12975,0,13.6,16.5,14.3,0,-2.9,14.3,8
21013,289,459,-123,734,-2,-170,-125,-294,23317,1,12.3,19.6,-5.2,-0.1,-7.2,-5.3,7
21015,1723,1075,428,1329,375,648,803,1451,140496,0,12.3,7.7,3.1,2.7,4.6,5.7,1
21017,208,286,83,97,20,-78,103,25,20134,0,10.3,14.2,4.1,1,-3.9,5.1,2
21019,477,739,24,2449,4,-262,28,-233,47826,1,9.9,15.4,0.5,0.1,-5.5,0.6,2
21021,311,385,188,2978,20,-74,208,137,30988,3,10.1,12.5,6.1,0.6,-2.4,6.7,7
21023,94,115,8,27,5,-21,13,-9,8426,-1,11.1,13.6,0.9,0.6,-2.5,1.5,1
21025,143,235,-311,272,1,-92,-310,-405,12953,-3,10.9,17.9,-23.6,0.1,-7,-23.6,9
21027,254,318,224,294,2,-64,226,163,21124,1,12.1,15.1,10.6,0.1,-3,10.7,8
21029,771,810,1029,136,103,-39,1132,1089,84863,-4,9.1,9.6,12.2,1.2,-0.5,13.4,1
21031,151,166,1,158,24,-15,25,10,12375,0,12.2,13.4,0.1,1.9,-1.2,2,3
21033,167,182,-36,216,-7,-15,-43,-57,12551,1,13.3,14.5,-2.9,-0.6,-1.2,-3.4,7
21035,356,477,261,3486,47,-121,308,187,38280,0,9.3,12.5,6.8,1.2,-3.2,8.1,7
21037,967,857,271,2627,43,110,314,430,93702,6,10.3,9.2,2.9,0.5,1.2,3.4,1
21039,59,96,21,50,1,-37,22,-15,4704,0,12.5,20.4,4.5,0.2,-7.9,4.7,3
21041,162,150,37,286,0,12,37,48,10987,-1,14.8,13.7,3.4,0,1.1,3.4,6
21043,272,441,194,663,0,-169,194,23,26366,-2,10.3,16.7,7.4,0,-6.4,7.4,2
21045,180,236,62,442,0,-56,62,7,15918,1,11.3,14.8,3.9,0,-3.5,3.9,9
21047,1295,771,-863,4918,83,524,-780,-254,72032,2,17.9,10.7,-12,1.2,7.3,-10.8,2
21049,410,492,389,440,6,-82,395,312,37304,-1,11,13.2,10.5,0.2,-2.2,10.6,2
2105,18,28,-9,28,3,-10,-6,-17,2262,-1,7.9,12.3,-4,1.3,-4.4,-2.6,9
21051,232,344,-121,1723,5,-112,-116,-226,19648,2,11.7,17.4,-6.1,0.3,-5.7,-5.9,9
21053,107,155,46,128,10,-48,56,9,9148,1,11.7,17,5,1.1,-5.2,6.1,9
21055,102,146,23,254,4,-44,27,-17,8974,0,11.4,16.3,2.6,0.4,-4.9,3,8
21057,74,110,69,80,1,-36,70,31,6000,-3,12.4,18.4,11.5,0.2,-6,11.7,9
21059,1308,1161,-26,2406,143,147,117,269,103458,5,12.7,11.2,-0.3,1.4,1.4,1.1,3
21061,108,180,218,143,0,-72,218,146,12448,0,8.7,14.5,17.6,0,-5.8,17.6,3
21063,52,97,-4,1114,0,-45,-4,-47,7245,2,7.2,13.3,-0.6,0,-6.2,-0.6,8
21065,126,237,15,90,8,-111,23,-88,13936,0,9,17,1.1,0.6,-7.9,1.6,8
21067,3696,2594,-2644,11923,1414,1102,-1230,-127,320154,1,11.5,8.1,-8.3,4.4,3.4,-3.8,2
21069,205,208,168,169,-2,-3,166,164,15442,1,13.3,13.5,10.9,-0.1,-0.2,10.8,9
21071,367,655,-213,268,5,-288,-208,-495,34423,1,10.6,18.9,-6.1,0.1,-8.3,-6,7
21073,512,697,191,1667,91,-185,282,96,51644,-1,9.9,13.5,3.7,1.8,-3.6,5.5,4
21075,73,121,16,539,-1,-48,15,-33,6338,0,11.5,19,2.5,-0.2,-7.6,2.4,9
21077,112,113,16,108,4,-1,20,19,8792,0,12.8,12.9,1.8,0.5,-0.1,2.3,1
21079,175,234,300,140,24,-59,324,263,17829,-2,9.9,13.2,17,1.4,-3.3,18.3,8
21081,361,305,87,325,1,56,88,145,25619,1,14.1,11.9,3.4,0,2.2,3.4,1
21083,465,507,-28,366,37,-42,9,-32,36461,1,12.7,13.9,-0.8,1,-1.2,0.2,6
21085,376,409,213,752,0,-33,213,182,26825,2,14.1,15.3,8,0,-1.2,8,6
21087,117,164,122,100,0,-47,122,76,11468,1,10.2,14.3,10.7,0,-4.1,10.7,8
21089,301,529,77,545,-2,-228,75,-154,35221,-1,8.5,15,2.2,-0.1,-6.5,2.1,2
21091,95,111,-90,90,0,-16,-90,-107,8920,-1,10.6,12.4,-10,0,-1.8,-10,8
21093,1369,1208,229,2509,143,161,372,530,112273,-3,12.2,10.8,2,1.3,1.4,3.3,3
21095,282,510,-100,561,0,-228,-100,-328,25324,0,11.1,20,-3.9,0,-8.9,-3.9,7
21097,255,286,342,311,0,-31,342,310,19415,-1,13.2,14.8,17.8,0,-1.6,17.8,6
21099,257,257,130,239,0,0,130,130,19724,0,13.1,13.1,6.6,0,0,6.6,8
2110,284,214,-314,902,58,70,-256,-185,31555,1,9,6.8,-9.9,1.8,2.2,-8.1,5
21101,514,584,142,994,16,-70,158,87,44119,-1,11.7,13.2,3.2,0.4,-1.6,3.6,4
21103,198,219,231,93,4,-21,235,213,15973,-1,12.5,13.8,14.6,0.3,-1.3,14.8,1
21105,41,78,51,120,1,-37,52,13,4447,-2,9.2,17.6,11.5,0.2,-8.3,11.7,8
21107,524,651,75,979,55,-127,130,3,44929,0,11.7,14.5,1.7,1.2,-2.8,2.9,5
21109,161,193,148,94,-1,-32,147,115,13104,0,12.3,14.8,11.3,-0.1,-2.5,11.3,9
21111,9534,8371,-5371,13880,3247,1163,-2124,-951,772144,10,12.3,10.8,-7,4.2,1.5,-2.7,1
21113,618,542,608,1447,95,76,703,781,55017,2,11.3,9.9,11.1,1.7,1.4,12.9,2
21115,231,378,22,386,5,-147,27,-119,22116,1,10.4,17,1,0.2,-6.6,1.2,7
21117,2158,1486,129,1800,234,672,363,1041,171321,6,12.6,8.7,0.8,1.4,3.9,2.1,1
21119,108,254,-45,625,5,-146,-40,-188,13659,-2,7.9,18.5,-3.3,0.4,-10.6,-2.9,9
21121,377,497,129,939,11,-120,140,21,29794,1,12.7,16.7,4.3,0.4,-4,4.7,7
21123,158,203,200,157,-1,-45,199,153,15303,-1,10.4,13.3,13.1,-0.1,-3,13.1,3
21125,705,803,499,1082,16,-98,515,417,63296,0,11.2,12.7,7.9,0.3,-1.6,8.2,5
21127,142,266,23,131,6,-124,29,-97,16000,-2,8.8,16.6,1.4,0.4,-7.7,1.8,2
21129,65,133,88,1146,0,-68,88,20,7293,0,8.9,18.3,12.1,0,-9.3,12.1,9
21131,95,199,-80,324,0,-104,-80,-185,9864,-1,9.5,20,-8,0,-10.4,-8,9
21133,179,409,-174,309,0,-230,-174,-404,20423,0,8.7,19.8,-8.4,0,-11.2,-8.4,9
21135,161,211,88,145,0,-50,88,36,12973,-2,12.4,16.3,6.8,0,-3.9,6.8,8
21137,312,382,428,175,-1,-70,427,357,24776,0,12.7,15.5,17.4,0,-2.8,17.4,9
21139,94,163,-7,63,0,-69,-7,-76,8892,0,10.5,18.3,-0.8,0,-7.7,-0.8,3
21141,368,370,421,341,8,-2,429,427,28283,0,13.1,13.2,15,0.3,-0.1,15.3,6
21143,53,137,159,1811,14,-84,173,88,9187,-1,5.8,15,17.4,1.5,-9.2,18.9,8
21145,696,933,283,2158,15,-237,298,62,67428,1,10.3,13.8,4.2,0.2,-3.5,4.4,3
21147,180,279,359,1916,5,-99,364,267,17050,2,10.6,16.5,21.2,0.3,-5.9,21.5,9
21149,94,137,-10,87,-1,-43,-11,-53,9054,1,10.4,15.1,-1.1,-0.1,-4.7,-1.2,3
21151,1058,942,1407,4836,63,116,1470,1584,96735,-2,11,9.8,14.7,0.7,1.2,15.3,4
21153,130,211,-39,121,-1,-81,-40,-120,11228,1,11.5,18.7,-3.5,-0.1,-7.2,-3.5,9
21155,212,244,111,546,7,-32,118,86,19834,0,10.7,12.3,5.6,0.4,-1.6,6,6
21157,304,450,102,442,-2,-146,100,-46,31744,0,9.6,14.2,3.2,-0.1,-4.6,3.1,8
21159,100,167,-100,1569,-1,-67,-101,-168,10928,0,9.1,15.2,-9.1,-0.1,-6.1,-9.2,8
21161,186,251,-6,251,9,-65,3,-62,16841,0,11,14.9,-0.4,0.5,-3.9,0.2,6
21163,267,307,141,219,19,-40,160,121,30131,1,8.9,10.2,4.7,0.6,-1.3,5.3,1
21165,72,107,87,56,-1,-35,86,50,6286,-1,11.5,17.1,13.9,-0.2,-5.6,13.7,9
21167,254,333,277,258,-1,-79,276,197,23097,0,11,14.5,12,0,-3.4,12,6
21169,119,156,99,85,13,-37,112,74,10482,-1,11.4,14.9,9.5,1.2,-3.5,10.7,9
21171,147,182,-12,102,-1,-35,-13,-47,11306,1,13,16.1,-1.1,-0.1,-3.1,-1.1,8
21173,326,373,212,304,6,-47,218,170,28527,-1,11.5,13.1,7.5,0.2,-1.7,7.7,6
21175,130,176,160,2028,26,-46,186,137,14283,-3,9.1,12.4,11.3,1.8,-3.2,13.1,9
21177,339,448,-22,1753,3,-109,-19,-128,30568,0,11.1,14.6,-0.7,0.1,-3.6,-0.6,6
21179,553,542,318,640,40,11,358,371,47730,2,11.6,11.4,6.7,0.8,0.2,7.5,1
21181,99,117,-82,104,0,-18,-82,-100,7686,0,12.8,15.1,-10.6,0,-2.3,-10.6,8
21183,256,346,151,250,70,-90,221,130,23626,-1,10.9,14.7,6.4,3,-3.8,9.4,6
21185,546,473,600,4178,79,73,679,739,70183,-13,7.8,6.8,8.6,1.1,1,9.7,1
21187,109,151,59,98,2,-42,61,19,11313,0,9.6,13.4,5.2,0.2,-3.7,5.4,8
21189,55,85,73,92,0,-30,73,43,4001,0,13.8,21.4,18.3,0,-7.5,18.3,9
21191,166,183,122,208,2,-17,124,107,14810,0,11.2,12.4,8.3,0.1,-1.2,8.4,1
21193,312,511,-40,656,6,-199,-34,-234,27133,-1,11.4,18.8,-1.5,0.2,-7.3,-1.2,7
21195,536,937,43,1878,13,-401,56,-344,55973,1,9.5,16.7,0.8,0.2,-7.1,1,7
21197,166,214,-19,295,-1,-48,-20,-69,12972,-1,12.8,16.5,-1.5,-0.1,-3.7,-1.5,8
21199,691,917,629,1162,23,-226,652,424,66191,-2,10.5,13.9,9.5,0.3,-3.4,9.9,5
21201,20,38,83,54,2,-18,85,66,2313,-1,8.8,16.7,36.4,0.9,-7.9,37.3,8
21203,162,282,85,310,0,-120,85,-35,16190,0,10,17.4,5.2,0,-7.4,5.2,9
21205,272,291,25,2750,31,-19,56,37,24409,0,11.2,11.9,1,1.3,-0.8,2.3,6
21207,211,274,143,208,15,-63,158,94,18279,-1,11.6,15,7.8,0.8,-3.5,8.7,9
21209,699,491,848,1112,36,208,884,1091,60168,-1,11.7,8.2,14.2,0.6,3.5,14.8,2
21211,568,492,509,1189,87,76,596,673,49515,1,11.5,10,10.4,1.8,1.5,12.1,1
21213,211,256,303,529,-8,-45,295,247,20195,-3,10.5,12.8,15.1,-0.4,-2.2,14.7,6
21215,201,186,295,87,11,15,306,319,20531,-2,9.9,9.1,14.5,0.5,0.7,15,1
21217,324,402,110,1430,15,-78,125,47,26443,0,12.3,15.2,4.2,0.6,-3,4.7,7
21219,175,167,72,145,19,8,91,100,12494,1,14.1,13.4,5.8,1.5,0.6,7.3,8
2122,636,549,486,1802,38,87,524,612,61223,1,10.4,9,8,0.6,1.4,8.6,7
21221,158,221,85,58,0,-63,85,21,14369,-1,11,15.4,5.9,0,-4.4,5.9,2
21223,87,132,121,38,4,-45,125,80,8607,0,10.2,15.4,14.1,0.5,-5.3,14.6,8
21225,164,203,39,438,1,-39,40,2,13106,1,12.5,15.5,3,0.1,-3,3.1,8
21227,1898,1207,909,5700,572,691,1481,2183,142229,11,13.4,8.6,6.4,4.1,4.9,10.5,3
21229,133,162,226,314,11,-29,237,207,12267,-1,10.9,13.3,18.6,0.9,-2.4,19.5,8
21231,209,287,17,312,7,-78,24,-54,19580,0,10.7,14.6,0.9,0.4,-4,1.2,7
21233,172,190,-14,401,20,-18,6,-13,12726,-1,13.5,14.9,-1.1,1.6,-1.4,0.5,9
21235,544,583,-55,1717,9,-39,-46,-83,36825,2,14.8,15.8,-1.5,0.2,-1.1,-1.2,7
21237,88,148,-74,130,1,-60,-73,-134,6282,-1,13.9,23.3,-11.7,0.2,-9.5,-11.5,9
21239,273,297,204,547,36,-24,240,215,27268,-1,10.1,10.9,7.5,1.3,-0.9,8.8,2
2130,119,109,-72,380,29,10,-43,-34,13738,-1,8.7,7.9,-5.2,2.1,0.7,-3.1,7
2150,158,88,-234,457,91,70,-143,-74,12565,-1,12.5,7,-18.6,7.2,5.6,-11.3,7
2158,216,72,-356,14,1,144,-355,-213,8001,-2,26.6,8.9,-43.9,0.1,17.8,-43.8,9
2164,16,11,-51,31,1,5,-50,-46,1331,-1,11.8,8.1,-37.7,0.7,3.7,-36.9,9
2170,1370,862,1198,2823,57,508,1255,1767,115239,4,12,7.5,10.5,0.5,4.4,11,2
2180,169,84,-124,283,8,85,-116,-28,9763,3,17.3,8.6,-12.7,0.8,8.7,-11.9,9
2185,126,63,-313,3193,43,63,-270,-208,10603,-1,11.8,5.9,-29.2,4,5.9,-25.2,9
2188,141,79,-154,237,-1,62,-155,-92,7361,1,19,10.7,-20.8,-0.1,8.4,-20.9,9
2195,25,28,37,186,25,-3,62,57,3427,-2,7.4,8.2,10.9,7.4,-0.9,18.2,9
2198,73,76,48,37,2,-3,50,46,5696,-1,12.9,13.4,8.5,0.4,-0.5,8.8,9
22000,56209,50094,-29692,123627,9274,6115,-20418,-14274,4573749,29,12.3,10.9,-6.5,2,1.3,-4.5,
22001,834,806,-262,697,-7,28,-269,-236,56489,5,14.7,14.2,-4.6,-0.1,0.5,-4.8,2
22003,237,330,-120,2806,38,-93,-82,-175,22112,0,10.7,14.9,-5.4,1.7,-4.2,-3.7,6
22005,1631,906,346,618,75,725,421,1147,131632,1,12.4,6.9,2.6,0.6,5.5,3.2,2
22007,210,310,-205,161,1,-100,-204,-303,20160,1,10.3,15.3,-10.1,0,-4.9,-10,2
22009,442,578,-205,2803,29,-136,-176,-307,38408,5,11.5,15,-5.3,0.8,-3.5,-4.6,6
22011,508,433,120,1058,8,75,128,203,36827,0,13.8,11.8,3.3,0.2,2,3.5,6
22013,165,253,-162,311,4,-88,-158,-246,12366,0,13.2,20.3,-13,0.3,-7,-12.7,8
22015,1573,1223,-14,2123,300,350,286,642,129795,6,12.1,9.4,-0.1,2.3,2.7,2.2,2
22017,2748,2818,-2616,4052,141,-70,-2475,-2548,226386,-3,12.1,12.4,-11.5,0.6,-0.3,-10.9,2
22019,2499,2060,650,2597,393,439,1043,1473,203761,-9,12.3,10.1,3.2,1.9,2.2,5.1,2
22021,85,148,-44,708,2,-63,-42,-104,9389,1,9,15.7,-4.7,0.2,-6.7,-4.4,8
22023,60,52,-137,22,-2,8,-139,-128,4768,3,12.4,10.8,-28.4,-0.4,1.7,-28.8,2
22025,77,142,-126,500,1,-65,-125,-190,8414,0,9,16.7,-14.8,0.1,-7.6,-14.7,9
22027,142,196,-123,1793,0,-54,-123,-179,13670,-2,10.3,14.2,-8.9,0,-3.9,-8.9,9
22029,105,287,-223,874,65,-182,-158,-338,17688,2,5.9,16.1,-12.5,3.6,-10.2,-8.8,6
22031,335,356,281,277,0,-21,281,258,27114,-2,12.4,13.2,10.4,0,-0.8,10.4,2
22033,5455,4160,-4674,17292,1739,1295,-2935,-1624,448467,16,12.1,9.3,-10.4,3.9,2.9,-6.5,2
22035,63,112,-61,1662,-1,-49,-62,-110,6829,1,9.2,16.3,-8.9,-0.1,-7.1,-9,8
22037,175,283,132,2838,0,-108,132,21,19229,-3,9.1,14.7,6.9,0,-5.6,6.9,2
22039,453,445,-400,1442,113,8,-287,-279,31754,0,14.2,14,-12.5,3.5,0.3,-9,6
22041,235,294,-15,338,1,-59,-14,-73,19285,0,12.2,15.2,-0.8,0.1,-3.1,-0.7,6
22043,261,262,-138,2959,13,-1,-125,-129,21911,-3,11.9,11.9,-6.3,0.6,0,-5.7,3
22045,873,845,-762,660,72,28,-690,-661,67659,1,12.8,12.4,-11.2,1.1,0.4,-10.1,4
22047,345,418,10,2788,66,-73,76,4,29617,1,11.6,14.1,0.3,2.2,-2.5,2.6,2
22049,120,219,2,705,29,-99,31,-70,14746,-2,8.1,14.8,0.1,2,-6.7,2.1,6
22051,5202,4223,-7945,2937,2753,979,-5192,-4253,421777,-40,12.3,10,-18.7,6.5,2.3,-12.2,1
22053,435,480,-327,662,-3,-45,-330,-376,31553,-1,13.7,15.1,-10.3,-0.1,-1.4,-10.4,2
22055,3388,2063,12,2782,688,1325,700,2036,249750,11,13.6,8.3,0,2.8,5.3,2.8,2
22057,1115,1063,-772,2430,22,52,-750,-695,95056,3,11.7,11.1,-8.1,0.2,0.5,-7.9,3
22059,169,191,-8,2003,8,-22,0,-21,14800,1,11.4,12.9,-0.5,0.5,-1.5,0,8
22061,465,462,-43,5294,21,3,-22,-18,47962,1,9.7,9.6,-0.9,0.4,0.1,-0.5,4
22063,1842,1345,1422,1046,171,497,1593,2089,150145,-1,12.4,9,9.5,1.1,3.3,10.7,2
22065,131,141,-226,825,4,-10,-222,-234,9246,-2,14,15.1,-24.1,0.4,-1.1,-23.7,6
22067,269,480,-255,1159,7,-211,-248,-459,23955,0,11.1,19.8,-10.5,0.3,-8.7,-10.3,3
22069,425,509,-276,2113,5,-84,-271,-357,36291,-2,11.7,14,-7.6,0.1,-2.3,-7.4,6
22071,4111,3387,-7468,15504,964,724,-6504,-5781,364136,-1,11.2,9.2,-20.3,2.6,2,-17.7,1
22073,2016,1748,-583,5281,168,268,-415,-136,157568,11,12.8,11.1,-3.7,1.1,1.7,-2.6,3
22075,291,212,-338,788,27,79,-311,-232,22386,0,12.9,9.4,-15,1.2,3.5,-13.8,1
22077,249,315,-165,153,21,-66,-144,-212,20000,-2,12.4,15.7,-8.2,1,-3.3,-7.2,2
22079,1631,1671,-817,3336,78,-40,-739,-768,126260,11,12.9,13.2,-6.5,0.6,-0.3,-5.8,3
22081,95,130,-73,168,0,-35,-73,-109,7356,-1,12.8,17.5,-9.9,0,-4.7,-9.9,8
22083,260,281,-76,1019,24,-21,-52,-72,19712,1,13.2,14.2,-3.8,1.2,-1.1,-2.6,3
22085,264,361,29,343,0,-97,29,-68,21906,0,12,16.5,1.3,0,-4.4,1.3,8
22087,575,460,-137,224,64,115,-73,44,44463,2,12.9,10.4,-3.1,1.4,2.6,-1.6,1
22089,576,468,-553,585,5,108,-548,-438,50620,2,11.3,9.2,-10.9,0.1,2.1,-10.8,1
22091,96,168,21,108,37,-72,58,-15,10774,-1,8.9,15.6,1.9,3.4,-6.7,5.4,2
22093,213,249,-170,141,8,-36,-162,-197,19191,1,11,12.9,-8.8,0.4,-1.9,-8.4,1
22095,471,456,-413,366,30,15,-383,-363,39592,5,11.8,11.5,-10.4,0.8,0.4,-9.6,1
22097,1188,1111,-366,1216,70,77,-296,-215,81464,4,14.6,13.6,-4.5,0.9,0.9,-3.6,4
22099,630,576,-275,272,32,54,-243,-192,51057,-3,12.3,11.3,-5.4,0.6,1.1,-4.8,2
22101,616,661,-821,668,105,-45,-716,-764,47055,-3,13,13.9,-17.3,2.2,-0.9,-15.1,4
22103,3081,2490,1264,2496,493,591,1757,2346,275583,-2,11.2,9.1,4.6,1.8,2.2,6.4,2
22105,1970,1520,735,4503,68,450,803,1265,138064,12,14.3,11.1,5.3,0.5,3.3,5.8,3
22107,18,86,18,0,0,-68,18,-50,3764,0,4.8,22.7,4.8,0,-17.9,4.8,9
22109,1367,1242,-1272,1023,130,125,-1142,-1016,103616,1,13.1,11.9,-12.2,1.2,1.2,-11,3
22111,195,338,53,416,12,-143,65,-79,20650,-1,9.4,16.3,2.6,0.6,-6.9,3.1,3
22113,749,702,-11,571,1,47,-10,39,56992,2,13.1,12.3,-0.2,0,0.8,-0.2,2
22115,814,443,-1065,1411,80,371,-985,-620,46250,-6,17.5,9.5,-22.9,1.7,8,-21.2,4
22117,566,687,-5,1767,-1,-121,-6,-126,44865,1,12.6,15.3,-0.1,0,-2.7,-0.1,6
22119,393,640,-69,391,25,-247,-44,-289,35238,2,11.1,18.1,-2,0.7,-7,-1.2,6
22121,337,278,156,608,14,59,170,232,28266,3,12,9.9,5.5,0.5,2.1,6,2
22123,110,150,-120,56,1,-40,-119,-158,9323,1,11.7,16,-12.8,0.1,-4.3,-12.7,8
22125,120,165,19,5381,1,-45,20,-25,15371,0,7.8,10.7,1.2,0.1,-2.9,1.3,2
22127,135,206,-26,1497,61,-71,35,-35,13216,1,10.2,15.6,-2,4.6,-5.4,2.6,8
2220,76,69,-98,330,21,7,-77,-71,8282,-1,9.1,8.3,-11.8,2.5,0.8,-9.3,7
2230,9,8,-4,29,4,1,0,3,1095,2,8.2,7.3,-3.7,3.7,0.9,0,9
2240,98,54,-8,638,23,44,15,61,7077,2,13.9,7.7,-1.1,3.3,6.2,2.1,9
2275,19,24,-1,25,0,-5,-1,-7,2064,-1,9.2,11.6,-0.5,0,-2.4,-0.5,9
2282,3,2,0,36,1,1,1,2,687,0,4.4,2.9,0,1.5,1.5,1.5,9
2290,55,75,-34,126,14,-20,-20,-40,5129,0,10.7,14.6,-6.6,2.7,-3.9,-3.9,8
23000,11945,16998,9216,41513,2209,-5053,11425,6384,1395722,12,8.6,12.2,6.6,1.6,-3.6,8.2,
23001,1136,1429,478,5898,346,-293,824,540,113765,9,10,12.6,4.2,3,-2.6,7.3,3
23003,640,1084,435,1592,40,-444,475,29,67351,-2,9.5,16.1,6.5,0.6,-6.6,7.1,7
23005,2922,3059,401,10409,1133,-137,1534,1393,310230,-4,9.4,9.9,1.3,3.7,-0.4,5,2
23007,226,411,403,1832,16,-185,419,233,30828,-1,7.4,13.4,13.1,0.5,-6,13.6,8
23009,372,752,315,1354,40,-380,355,-23,56526,2,6.6,13.3,5.6,0.7,-6.7,6.3,8
23011,1110,1605,1092,4314,127,-495,1219,724,127259,0,8.7,12.6,8.6,1,-3.9,9.6,4
23013,280,542,42,1431,20,-262,62,-202,40977,-2,6.8,13.2,1,0.5,-6.4,1.5,7
23015,258,450,412,570,2,-192,414,222,36507,0,7.1,12.4,11.3,0.1,-5.3,11.4,8
23017,441,831,829,845,9,-390,838,447,59905,-1,7.4,13.9,13.9,0.2,-6.5,14,6
23019,1298,1950,1032,6783,205,-652,1237,584,155312,-1,8.4,12.6,6.7,1.3,-4.2,8,3
23021,130,306,251,242,8,-176,259,83,17486,0,7.5,17.5,14.4,0.5,-10.1,14.8,8
23023,315,441,255,340,14,-126,269,141,37513,-2,8.4,11.8,6.8,0.4,-3.4,7.2,2
23025,472,759,458,665,10,-287,468,184,51302,3,9.2,14.8,8.9,0.2,-5.6,9.1,6
23027,359,531,526,832,7,-172,533,365,40620,4,8.9,13.1,13,0.2,-4.3,13.2,8
23029,287,529,252,827,17,-242,269,28,31555,1,9.1,16.8,8,0.5,-7.7,8.5,9
23031,1699,2319,2035,3579,215,-620,2250,1636,218586,6,7.8,10.6,9.3,1,-2.8,10.3,2
24000,67969,53770,-30905,125196,32977,14199,2072,16272,6180253,1,11,8.7,-5,5.3,2.3,0.3,
24001,553,1001,427,6178,33,-448,460,7,67273,-5,8.2,14.9,6.3,0.5,-6.7,6.8,4
24003,6971,4570,-2732,9584,1525,2401,-1207,1235,594582,41,11.7,7.7,-4.6,2.6,4,-2,1
24005,9375,8577,-5765,22361,3663,798,-2102,-1283,844703,21,11.1,10.1,-6.8,4.3,0.9,-2.5,1
24009,957,834,-28,582,78,123,50,169,94728,-4,10.1,8.8,-0.3,0.8,1.3,0.5,3
24011,423,430,68,563,103,-7,171,166,33593,2,12.6,12.8,2,3.1,-0.2,5.1,6
24013,1795,1758,944,3745,215,37,1159,1167,176639,-29,10.2,10,5.4,1.2,0.2,6.6,1
24015,1124,1194,733,1384,142,-70,875,802,105672,-3,10.7,11.3,7,1.3,-0.7,8.3,1
24017,1724,1421,1174,1440,395,303,1569,1862,171973,-10,10.1,8.3,6.9,2.3,1.8,9.2,1
24019,336,489,413,380,32,-153,445,296,32879,4,10.3,14.9,12.6,1,-4.7,13.6,6
24021,3172,2066,3551,5186,1215,1106,4766,5851,293391,-21,10.9,7.1,12.2,4.2,3.8,16.4,1
24023,215,389,4,606,6,-174,10,-165,28423,-1,7.5,13.6,0.1,0.2,-6.1,0.4,8
24025,2624,2413,481,1825,148,211,629,829,264644,-11,9.9,9.1,1.8,0.6,0.8,2.4,1
24027,3236,1901,-2222,3090,1500,1335,-722,635,336001,22,9.6,5.7,-6.6,4.5,4,-2.2,1
24029,145,312,139,1355,37,-167,176,8,19303,-1,7.5,16.2,7.2,1.9,-8.7,9.1,6
24031,11709,6412,-11153,8704,11191,5297,38,5407,1058474,72,11.1,6.1,-10.6,10.6,5,0,1
24033,10619,6954,-12516,19787,9345,3665,-3171,450,947430,-44,11.2,7.3,-13.2,9.9,3.9,-3.3,1
24035,533,522,675,359,107,11,782,788,52508,-5,10.2,10,13,2.1,0.2,15,1
24037,1405,1025,-96,2358,210,380,114,498,115281,4,12.2,8.9,-0.8,1.8,3.3,1,3
24039,218,315,340,4877,59,-97,399,302,24910,0,8.8,12.7,13.7,2.4,-3.9,16.1,3
24041,304,543,163,472,88,-239,251,9,37823,-3,8,14.4,4.3,2.3,-6.3,6.6,6
24043,1554,1900,693,7979,212,-346,905,556,155813,-3,10,12.2,4.5,1.4,-2.2,5.8,2
24045,1276,1201,-234,3675,467,75,233,314,104800,6,12.2,11.5,-2.2,4.5,0.7,2.2,3
24047,459,716,425,737,70,-257,495,237,54171,-1,8.5,13.2,7.9,1.3,-4.8,9.2,4
24510,7242,6827,-6389,17969,2136,415,-4253,-3868,565239,-30,12.8,12,-11.3,3.8,0.7,-7.5,1
25000,68387,61404,-39149,240786,50647,6983,11498,18659,7001399,178,9.8,8.8,-5.6,7.2,1,1.6,
25001,1504,3208,539,4049,836,-1704,1375,-343,231735,-14,6.5,13.8,2.3,3.6,-7.3,5.9,3
25003,888,1685,-195,5321,263,-797,68,-729,126818,0,7,13.2,-1.5,2.1,-6.3,0.5,3
25005,5475,6004,531,12942,2092,-529,2623,2097,581841,3,9.4,10.3,0.9,3.6,-0.9,4.5,1
25007,177,173,-324,81,176,4,-148,-143,20819,1,8.5,8.3,-15.5,8.4,0.2,-7.1,7
25009,8482,7227,-3691,18410,5988,1255,2297,3590,810089,38,10.5,8.9,-4.6,7.4,1.6,2.8,1
25011,495,754,-51,1498,152,-259,101,-159,70836,-1,7,10.6,-0.7,2.1,-3.7,1.4,4
25013,4808,4951,-1931,14189,1581,-143,-350,-467,460291,26,10.4,10.8,-4.2,3.4,-0.3,-0.8,2
25015,937,1419,-292,23924,755,-482,463,-16,162502,3,5.8,8.7,-1.8,4.6,-3,2.8,3
25017,16102,11957,-13402,56066,16339,4145,2937,7158,1623952,76,9.9,7.4,-8.3,10.1,2.6,1.8,1
25019,159,88,-122,64,51,71,-71,1,14444,1,11,6.1,-8.4,3.5,4.9,-4.9,7
25021,7196,6056,-4372,16144,5181,1140,809,2004,727473,55,9.9,8.3,-6,7.1,1.6,1.1,1
25023,5395,5289,228,10977,1722,106,1950,2060,535308,4,10.1,9.9,0.4,3.2,0.2,3.6,1
25025,8210,4932,-14207,49889,10606,3278,-3601,-387,768425,-64,10.7,6.4,-18.5,13.8,4.3,-4.7,1
25027,8559,7661,-1860,27232,4905,898,3045,3993,866866,50,9.9,8.9,-2.2,5.7,1,3.5,2
26000,101911,105941,-15051,215992,22817,-4030,7766,3980,10037261,244,10.2,10.6,-1.5,2.3,-0.4,0.8,
26001,63,216,235,80,9,-153,244,92,10489,1,6,20.7,22.5,0.9,-14.7,23.4,9
26003,67,114,30,916,0,-47,30,-16,8757,1,7.6,13,3.4,0,-5.4,3.4,9
26005,1227,1163,486,935,97,64,583,649,121939,2,10.1,9.6,4,0.8,0.5,4.8,4
26007,269,447,246,577,4,-178,250,71,28904,-1,9.3,15.5,8.5,0.1,-6.2,8.7,7
26009,187,319,262,203,17,-132,279,144,24409,-3,7.7,13.1,10.8,0.7,-5.4,11.5,8
26011,132,247,137,172,0,-115,137,22,15145,0,8.7,16.3,9.1,0,-7.6,9.1,8
26013,69,116,73,883,0,-47,73,27,8310,1,8.3,14,8.8,0,-5.7,8.8,9
26015,604,711,508,460,10,-107,518,406,63808,-5,9.5,11.2,8,0.2,-1.7,8.1,1
26017,865,1409,396,1168,14,-544,410,-138,102500,-4,8.4,13.7,3.9,0.1,-5.3,4,3
26019,138,231,196,193,13,-93,209,114,18441,-2,7.5,12.6,10.7,0.7,-5.1,11.4,3
26021,1584,1824,-563,2517,225,-240,-338,-574,152261,4,10.4,12,-3.7,1.5,-1.6,-2.2,3
26023,530,533,575,1870,135,-3,710,713,45215,6,11.8,11.9,12.8,3,-0.1,15.8,6
26025,1517,1670,-1,2780,94,-153,93,-58,133366,2,11.4,12.5,0,0.7,-1.1,0.7,3
26027,446,601,308,752,13,-155,321,165,51642,-1,8.7,11.7,6,0.3,-3,6.2,2
26029,201,357,125,295,20,-156,145,-14,26159,-3,7.7,13.6,4.8,0.8,-6,5.5,7
26031,192,417,292,292,15,-225,307,84,26048,2,7.4,16,11.2,0.6,-8.7,11.8,7
26033,291,445,167,4155,43,-154,210,57,36264,1,8,12.3,4.6,1.2,-4.2,5.8,7
26035,305,518,216,342,4,-213,220,9,31316,2,9.7,16.5,6.9,0.1,-6.8,7,8
26037,675,712,46,667,59,-37,105,68,79720,0,8.5,8.9,0.6,0.7,-0.5,1.3,2
26039,107,220,213,191,3,-113,216,104,13538,1,7.9,16.3,15.8,0.2,-8.4,16,9
26041,314,528,228,552,-4,-214,224,9,36790,-1,8.5,14.4,6.2,-0.1,-5.8,6.1,5
26043,212,341,164,388,7,-129,171,39,25982,-3,8.2,13.1,6.3,0.3,-5,6.6,7
26045,1075,1212,-44,1770,149,-137,105,-34,108820,-2,9.9,11.1,-0.4,1.4,-1.3,1,2
26047,260,371,15,422,5,-111,20,-92,34123,-1,7.6,10.9,0.4,0.1,-3.2,0.6,7
26049,4337,4972,-110,5135,331,-635,221,-401,401522,13,10.8,12.4,-0.3,0.8,-1.6,0.6,2
26051,226,450,456,195,0,-224,456,232,25853,0,8.8,17.5,17.7,0,-8.7,17.7,8
26053,77,202,-29,282,3,-125,-26,-153,14224,-2,5.4,14.1,-2,0.2,-8.7,-1.8,7
26055,893,1017,192,2045,54,-124,246,123,96421,1,9.3,10.6,2,0.6,-1.3,2.6,3
26057,355,496,390,5851,14,-141,404,264,41368,1,8.6,12,9.5,0.3,-3.4,9.8,6
26059,446,604,-3,1367,13,-158,10,-148,45587,0,9.8,13.2,-0.1,0.3,-3.5,0.2,6
26061,347,353,295,4092,146,-6,441,439,37599,4,9.3,9.4,7.9,3.9,-0.2,11.8,5
26063,277,492,-19,413,17,-215,-2,-218,30927,-1,8.9,15.9,-0.6,0.5,-6.9,-0.1,9
26065,2908,2556,-434,18924,1240,352,806,1160,284637,2,10.2,9,-1.5,4.4,1.2,2.8,2
26067,670,591,-673,6004,11,79,-662,-574,66262,9,10.1,8.9,-10.1,0.2,1.2,-9.9,1
26069,200,468,158,289,11,-268,169,-100,25373,-1,7.9,18.4,6.2,0.4,-10.5,6.6,7
26071,64,192,161,284,2,-128,163,35,11740,0,5.5,16.4,13.7,0.2,-10.9,13.9,9
26073,593,657,-247,4176,61,-64,-186,-248,64118,2,9.2,10.2,-3.8,0.9,-1,-2.9,4
26075,1611,1942,-84,9043,78,-331,-6,-334,159424,3,10.1,12.2,-0.5,0.5,-2.1,0,3
26077,2732,2412,152,7838,842,320,994,1323,262215,9,10.4,9.2,0.6,3.2,1.2,3.8,2
26079,184,239,294,215,4,-55,298,246,18490,3,10,13,16,0.2,-3,16.2,3
26081,8192,5154,-2453,11826,1838,3038,-615,2434,661354,11,12.4,7.8,-3.7,2.8,4.6,-0.9,1
26083,10,34,41,4,0,-24,41,17,2172,0,4.6,15.7,19,0,-11.1,19,9
26085,90,195,186,1233,2,-105,188,83,12734,0,7.1,15.4,14.7,0.2,-8.3,14.8,9
26087,769,1095,591,1663,82,-326,673,345,88977,-2,8.7,12.3,6.7,0.9,-3.7,7.6,1
26089,187,291,232,181,10,-104,242,136,23019,-2,8.1,12.7,10.1,0.4,-4.5,10.5,3
26091,739,1191,-413,4070,105,-452,-308,-760,97520,0,7.5,12.2,-4.2,1.1,-4.6,-3.1,4
26093,1629,1703,677,1382,34,-74,711,623,196757,-14,8.3,8.7,3.4,0.2,-0.4,3.6,1
26095,56,83,186,1249,-1,-27,185,161,6435,3,8.8,13.1,29.3,-0.2,-4.2,29.1,9
26097,81,187,-53,122,48,-106,-5,-111,10851,0,7.4,17.1,-4.9,4.4,-9.7,-0.5,9
26099,8630,9376,-212,7683,1820,-746,1608,866,875101,4,9.9,10.7,-0.2,2.1,-0.9,1.8,1
26101,194,357,347,1261,15,-163,362,197,25562,-2,7.6,14,13.6,0.6,-6.4,14.2,6
26103,561,737,582,4472,37,-176,619,451,66999,8,8.4,11,8.7,0.6,-2.6,9.3,5
26105,232,410,7,348,14,-178,21,-159,29159,-2,7.9,14,0.2,0.5,-6.1,0.7,7
26107,414,444,335,1005,10,-30,345,317,41099,2,10.1,10.8,8.2,0.2,-0.7,8.4,6
26109,73,313,-44,359,6,-240,-38,-280,22945,-2,3.2,13.6,-1.9,0.3,-10.4,-1.6,7
26111,862,858,188,1099,88,4,276,277,84039,-3,10.3,10.2,2.2,1,0,3.3,3
26113,158,199,109,167,9,-41,118,79,15311,2,10.3,13,7.1,0.6,-2.7,7.7,8
26115,1144,1740,292,1501,116,-596,408,-190,155045,-2,7.4,11.2,1.9,0.7,-3.8,2.6,3
26117,678,750,922,5641,87,-72,1009,945,68154,8,10,11.1,13.6,1.3,-1.1,14.9,1
26119,73,200,248,48,1,-127,249,121,9678,-1,7.6,20.8,25.8,0.1,-13.2,25.9,9
26121,1875,1949,1007,4800,91,-74,1098,1025,176564,1,10.7,11.1,5.7,0.5,-0.4,6.2,3
26123,493,588,440,713,34,-95,474,380,51108,1,9.7,11.5,8.6,0.7,-1.9,9.3,6
26125,12666,10964,-8944,14417,6558,1702,-2386,-599,1270426,85,10,8.6,-7,5.2,1.3,-1.9,1
26127,268,312,39,423,66,-44,105,61,26981,0,9.9,11.6,1.4,2.4,-1.6,3.9,8
26129,179,371,244,215,17,-192,261,71,20990,2,8.5,17.7,11.6,0.8,-9.2,12.5,9
26131,31,102,55,67,1,-71,56,-15,5906,0,5.2,17.2,9.3,0.2,-12,9.5,9
26133,232,273,80,382,12,-41,92,51,23330,0,10,11.7,3.4,0.5,-1.8,3.9,9
26135,77,164,240,36,2,-87,242,154,8545,-1,9.1,19.4,28.3,0.2,-10.3,28.6,9
26137,237,344,279,313,15,-107,294,186,25747,-1,9.2,13.4,10.9,0.6,-4.2,11.5,7
26139,3121,2281,1382,8807,234,840,1616,2454,303372,-2,10.3,7.5,4.6,0.8,2.8,5.3,1
26141,89,208,56,159,5,-119,61,-58,13285,0,6.7,15.6,4.2,0.4,-8.9,4.6,9
26143,151,442,470,201,1,-291,471,181,23863,1,6.4,18.6,19.8,0,-12.2,19.8,7
26145,1998,2354,-332,6153,89,-356,-243,-591,187782,8,10.6,12.5,-1.8,0.5,-1.9,-1.3,3
26147,1423,2079,809,1455,60,-656,869,206,159874,-7,8.9,13,5.1,0.4,-4.1,5.4,1
26149,645,734,137,401,49,-89,186,100,60878,3,10.6,12.1,2.3,0.8,-1.5,3.1,4
26151,396,595,56,512,29,-199,85,-114,40368,0,9.8,14.7,1.4,0.7,-4.9,2.1,8
26153,59,129,38,142,7,-70,45,-25,8149,0,7.2,15.8,4.7,0.9,-8.6,5.5,9
26155,665,805,189,465,14,-140,203,58,68025,-5,9.8,11.8,2.8,0.2,-2.1,3,4
26157,495,715,107,823,31,-220,138,-82,52826,0,9.4,13.5,2,0.6,-4.2,2.6,6
26159,815,904,128,447,95,-89,223,129,75798,-5,10.8,11.9,1.7,1.3,-1.2,2.9,6
26161,2936,2375,-3642,20845,2074,561,-1568,-968,365536,39,8,6.5,-10,5.7,1.5,-4.3,2
26163,20698,19095,-14685,19739,5231,1603,-9454,-7773,1751169,78,11.8,10.9,-8.4,3,0.9,-5.4,1
26165,340,476,219,430,22,-136,241,104,34122,-1,10,14,6.4,0.6,-4,7.1,6
27000,63754,49911,-4686,140494,14575,13843,9889,23615,5737915,-117,11.1,8.7,-0.8,2.5,2.4,1.7,
27001,101,243,94,324,9,-142,103,-40,16102,-1,6.3,15.1,5.8,0.6,-8.8,6.4,8
27003,4246,2629,835,3233,900,1617,1735,3333,372441,-19,11.5,7.1,2.3,2.4,4.4,4.7,1
27005,343,411,-23,471,11,-68,-12,-80,35283,0,9.7,11.6,-0.7,0.3,-1.9,-0.3,6
27007,574,514,127,2419,19,60,146,207,46718,1,12.3,11,2.7,0.4,1.3,3.1,7
27009,478,401,-115,718,124,77,9,91,41600,5,11.5,9.6,-2.8,3,1.9,0.2,3
27011,54,77,-23,242,2,-23,-21,-44,5105,0,10.5,15,-4.5,0.4,-4.5,-4.1,9
27013,700,584,42,4873,243,116,285,403,70006,2,10,8.4,0.6,3.5,1.7,4.1,3
27015,268,340,-93,1002,32,-72,-61,-134,25628,-1,10.4,13.2,-3.6,1.2,-2.8,-2.4,6
27017,390,462,336,2490,15,-72,351,281,36825,2,10.6,12.6,9.2,0.4,-2,9.6,2
27019,1217,646,211,899,155,571,366,937,111057,0,11,5.8,1.9,1.4,5.2,3.3,1
27021,285,432,276,329,9,-147,285,138,31446,0,9.1,13.8,8.8,0.3,-4.7,9.1,9
27023,164,168,-150,390,56,-4,-94,-97,12172,1,13.4,13.7,-12.3,4.6,-0.3,-7.7,7
27025,565,535,592,1594,19,30,611,637,58535,-4,9.7,9.2,10.2,0.3,0.5,10.5,1
27027,539,543,264,3335,137,-4,401,398,66258,1,8.2,8.2,4,2.1,-0.1,6.1,3
27029,83,122,45,93,1,-39,46,6,8644,-1,9.6,14.1,5.2,0.1,-4.5,5.3,8
27031,31,47,-85,43,20,-16,-65,-82,5639,-1,5.5,8.3,-15,3.5,-2.8,-11.4,9
27033,130,165,-39,319,11,-35,-28,-63,11319,0,11.5,14.5,-3.4,1,-3.1,-2.5,9
27035,637,780,546,1313,16,-143,562,420,68304,1,9.4,11.5,8,0.2,-2.1,8.3,4
27037,5038,3088,1193,3992,1042,1950,2235,4168,447440,-17,11.3,6.9,2.7,2.3,4.4,5,1
27039,268,166,-38,120,32,102,-6,96,21088,0,12.7,7.9,-1.8,1.5,4.8,-0.3,3
27041,396,443,285,793,33,-47,318,269,39953,-2,9.9,11.1,7.2,0.8,-1.2,8,6
27043,127,188,-3,148,6,-61,3,-57,13873,1,9.1,13.5,-0.2,0.4,-4.4,0.2,8
27045,227,246,59,415,29,-19,88,68,21522,-1,10.6,11.4,2.7,1.3,-0.9,4.1,3
27047,311,394,-105,498,20,-83,-85,-168,30515,0,10.2,12.9,-3.4,0.7,-2.7,-2.8,7
27049,486,552,20,763,37,-66,57,-6,48035,3,10.1,11.5,0.4,0.8,-1.4,1.2,6
27051,69,79,25,84,4,-10,29,18,6139,-1,11.3,12.9,4.1,0.7,-1.6,4.7,9
27053,14847,9452,-8236,30038,4530,5395,-3706,1647,1258713,-42,11.8,7.5,-6.5,3.6,4.3,-2.9,1
27055,66,200,-11,253,1,-134,-10,-145,18582,-1,3.5,10.7,-0.6,0.1,-7.2,-0.5,3
27057,220,244,179,269,12,-24,191,169,22132,2,10,11.1,8.1,0.5,-1.1,8.7,9
27059,479,435,409,357,19,44,428,471,43182,-1,11.2,10.1,9.5,0.4,1,10,1
27061,383,659,449,1055,1,-276,450,171,45365,-3,8.5,14.6,9.9,0,-6.1,9.9,6
27063,99,106,16,110,12,-7,28,21,9919,0,10,10.7,1.6,1.2,-0.7,2.8,9
27065,164,209,199,287,0,-45,199,153,16602,-1,9.9,12.6,12,0,-2.7,12,8
27067,527,438,-261,1029,213,89,-48,42,43813,1,12,10,-6,4.9,2,-1.1,4
27069,30,61,-1,109,7,-31,6,-26,4060,-1,7.4,15,-0.2,1.7,-7.6,1.5,9
27071,100,185,-12,227,1,-85,-11,-97,11751,-1,8.5,15.7,-1,0.1,-7.2,-0.9,7
27073,58,102,20,130,0,-44,20,-26,6630,-2,8.7,15.4,3,0,-6.6,3,9
27075,83,171,30,218,0,-88,30,-57,10855,1,7.6,15.7,2.8,0,-8.1,2.8,8
27077,38,50,-95,27,0,-12,-95,-108,3778,-1,9.9,13,-24.8,0,-3.1,-24.8,9
27079,320,284,32,306,63,36,95,131,29255,0,11,9.7,1.1,2.2,1.2,3.3,1
27081,46,102,-3,106,5,-56,2,-55,5521,-1,8.3,18.4,-0.5,0.9,-10.1,0.4,9
27083,294,243,-193,902,135,51,-58,-6,25427,1,11.6,9.6,-7.6,5.3,2,-2.3,7
27085,380,409,29,661,51,-29,80,51,36785,0,10.3,11.1,0.8,1.4,-0.8,2.2,4
27087,63,90,-33,67,1,-27,-32,-59,5280,0,11.9,17,-6.2,0.2,-5.1,-6,8
27089,82,96,-68,73,2,-14,-66,-79,8810,1,9.3,10.8,-7.7,0.2,-1.6,-7.5,8
27091,222,301,75,298,8,-79,83,1,19657,-3,11.3,15.3,3.8,0.4,-4,4.2,6
27093,259,243,-68,428,16,16,-52,-36,23490,0,11,10.3,-2.9,0.7,0.7,-2.2,6
27095,290,373,214,420,0,-83,214,132,27427,1,10.6,13.6,7.8,0,-3,7.8,1
27097,344,409,75,522,4,-65,79,13,34250,-1,10,11.9,2.2,0.1,-1.9,2.3,6
27099,499,441,-278,674,227,58,-51,8,40058,1,12.5,11,-6.9,5.7,1.4,-1.3,4
27101,60,109,50,76,9,-49,59,9,8049,-1,7.5,13.5,6.2,1.1,-6.1,7.3,9
27103,325,293,-191,3405,58,32,-133,-101,34242,0,9.5,8.5,-5.6,1.7,0.9,-3.9,3
27105,309,183,-492,516,135,126,-357,-231,21727,0,14.1,8.4,-22.5,6.2,5.8,-16.3,7
27107,55,86,-19,104,9,-31,-10,-42,6329,-1,8.7,13.5,-3,1.4,-4.9,-1.6,8
27109,2010,1237,-596,3118,565,773,-31,748,164784,6,12.2,7.5,-3.6,3.4,4.7,-0.2,3
27111,623,755,196,1280,20,-132,216,82,60626,-2,10.3,12.5,3.2,0.3,-2.2,3.6,6
27113,139,152,-97,283,9,-13,-88,-102,13714,-1,10.1,11,-7,0.7,-0.9,-6.4,6
27115,300,386,732,1565,14,-86,746,664,30197,4,10,12.9,24.5,0.5,-2.9,25,8
27117,106,133,-73,146,19,-27,-54,-82,9245,-1,11.4,14.3,-7.9,2,-2.9,-5.8,8
27119,292,373,-288,1293,55,-81,-233,-313,30412,1,9.6,12.2,-9.4,1.8,-2.6,-7.6,3
27121,126,147,-7,133,9,-21,2,-20,11400,-1,11,12.9,-0.6,0.8,-1.8,0.2,8
27123,6677,4716,-5799,17205,2641,1961,-3158,-1228,536075,-31,12.4,8.8,-10.8,4.9,3.7,-5.9,1
27125,46,43,29,30,0,3,29,30,3911,-2,11.8,11,7.4,0,0.8,7.4,8
27127,190,183,-86,290,8,7,-78,-70,15288,1,12.4,11.9,-5.6,0.5,0.5,-5.1,9
27129,134,203,-60,306,6,-69,-54,-125,14348,-2,9.3,14.1,-4.2,0.4,-4.8,-3.7,9
27131,671,602,85,7666,268,69,353,425,67948,3,9.9,8.9,1.3,4,1,5.2,4
27133,58,121,55,237,5,-63,60,-3,9551,0,6.1,12.7,5.8,0.5,-6.6,6.3,2
27135,176,170,-98,156,9,6,-89,-82,15252,1,11.5,11.1,-6.4,0.6,0.4,-5.8,9
27137,1844,2249,1264,9885,80,-405,1344,956,200514,17,9.2,11.2,6.3,0.4,-2,6.7,2
27139,1732,888,132,1319,411,844,543,1391,155814,4,11.2,5.7,0.9,2.6,5.4,3.5,1
27141,1183,697,1095,2573,96,486,1191,1666,102206,-11,11.7,6.9,10.8,0.9,4.8,11.7,1
27143,186,167,124,260,16,19,140,156,15084,-3,12.4,11.1,8.3,1.1,1.3,9.3,8
27145,1962,1229,-708,6779,696,733,-12,735,160977,14,12.2,7.7,-4.4,4.3,4.6,-0.1,3
27147,435,382,-109,497,45,53,-64,-8,37421,3,11.6,10.2,-2.9,1.2,1.4,-1.7,5
27149,110,74,19,724,58,36,77,113,9728,0,11.4,7.7,2,6,3.7,8,7
27151,114,93,-101,378,26,21,-75,-52,9719,2,11.7,9.5,-10.4,2.7,2.2,-7.7,9
27153,306,252,14,331,69,54,83,134,25667,-3,12,9.8,0.5,2.7,2.1,3.2,8
27155,24,62,-71,92,3,-38,-68,-106,3136,0,7.5,19.4,-22.3,0.9,-11.9,-21.3,9
27157,222,218,21,294,7,4,28,31,21683,-1,10.2,10.1,1,0.3,0.2,1.3,3
27159,189,220,14,356,23,-31,37,5,14241,-1,13.3,15.5,1,1.6,-2.2,2.6,9
27161,198,188,41,1003,17,10,58,67,18981,-1,10.4,9.9,2.2,0.9,0.5,3.1,6
27163,2796,1930,1396,3424,527,866,1923,2767,278936,-22,10.1,7,5,1.9,3.1,6.9,1
27165,174,129,-181,159,108,45,-73,-29,11077,-1,15.7,11.6,-16.3,9.7,4.1,-6.6,8
27167,46,89,-8,87,-1,-43,-9,-52,6306,0,7.3,14.1,-1.3,-0.2,-6.8,-1.4,8
27169,336,431,236,3819,107,-95,343,252,49721,4,6.8,8.7,4.8,2.2,-1.9,6.9,4
27171,1890,1058,2079,1126,132,832,2211,3032,151150,-11,12.6,7.1,13.9,0.9,5.6,14.8,1
27173,90,105,-28,113,26,-15,-2,-17,9467,0,9.5,11.1,-3,2.7,-1.6,-0.2,9
28000,34628,36032,-2614,93920,4800,-1404,2186,762,2939690,-20,11.8,12.3,-0.9,1.6,-0.5,0.7,
28001,311,416,-126,1321,459,-105,333,229,28746,1,10.9,14.5,-4.4,16,-3.7,11.6,7
28003,383,471,55,670,22,-88,77,-12,34135,-1,11.2,13.8,1.6,0.6,-2.6,2.3,7
28005,114,218,-14,72,2,-104,-12,-117,12442,-1,9.1,17.4,-1.1,0.2,-8.3,-1,8
28007,216,281,-106,251,-1,-65,-107,-171,17359,1,12.4,16.1,-6.1,-0.1,-3.7,-6.1,6
28009,72,125,-66,64,1,-53,-65,-118,7438,0,9.6,16.7,-8.8,0.1,-7.1,-8.7,1
28011,407,441,-509,1498,53,-34,-456,-493,28968,-3,13.9,15.1,-17.4,1.8,-1.2,-15.6,7
28013,166,220,-134,318,28,-54,-106,-161,12685,-1,13,17.2,-10.5,2.2,-4.2,-8.3,9
28015,72,147,-126,600,0,-75,-126,-201,9535,0,7.5,15.3,-13.1,0,-7.8,-13.1,8
28017,233,236,5,491,0,-3,5,3,16866,1,13.8,14,0.3,0,-0.2,0.3,9
28019,88,109,17,195,-2,-21,15,-7,8088,-1,10.9,13.5,2.1,-0.2,-2.6,1.9,9
28021,104,119,-163,1057,20,-15,-143,-158,8617,0,12,13.7,-18.7,2.3,-1.7,-16.4,8
28023,178,238,87,156,-1,-60,86,25,15228,-1,11.7,15.6,5.7,-0.1,-3.9,5.7,9
28025,212,269,-48,240,0,-57,-48,-105,18206,0,11.6,14.7,-2.6,0,-3.1,-2.6,7
28027,303,335,-289,555,165,-32,-124,-158,20077,-2,15,16.6,-14.3,8.2,-1.6,-6.2,6
28029,323,368,-96,932,96,-45,0,-48,27664,-3,11.7,13.3,-3.5,3.5,-1.6,0,2
28031,250,276,-55,271,-2,-26,-57,-83,18059,0,13.8,15.2,-3,-0.1,-1.4,-3.1,8
28033,1655,1712,1946,879,230,-57,2176,2103,193247,-16,8.6,8.9,10.1,1.2,-0.3,11.3,1
28035,1006,883,-92,5799,200,123,108,232,78208,1,12.9,11.3,-1.2,2.6,1.6,1.4,3
28037,89,134,43,63,2,-45,45,-1,7610,-1,11.7,17.6,5.7,0.3,-5.9,5.9,9
28039,384,343,344,483,34,41,378,420,25619,1,15.1,13.5,13.5,1.3,1.6,14.9,8
28041,134,137,41,2713,-1,-3,40,35,13601,-2,9.9,10.1,3,-0.1,-0.2,2.9,8
28043,232,310,-3,312,13,-78,10,-69,21065,-1,11,14.7,-0.1,0.6,-3.7,0.5,7
28045,425,564,255,219,33,-139,288,152,46159,3,9.2,12.2,5.5,0.7,-3,6.2,2
28047,2435,2308,-450,4564,497,127,47,169,210612,-5,11.6,11,-2.1,2.4,0.6,0.2,2
28049,2765,2302,-3581,8204,437,463,-3144,-2685,214870,-4,12.8,10.6,-16.6,2,2.1,-14.5,2
28051,205,279,-262,893,1,-74,-261,-334,15777,1,12.9,17.5,-16.4,0.1,-4.6,-16.4,2
28053,97,138,-101,73,5,-41,-96,-138,7216,-1,13.3,18.9,-13.9,0.7,-5.6,-13.2,8
28055,4,13,3,501,0,-9,3,-6,1256,0,3.2,10.3,2.4,0,-7.1,2.4,9
28057,301,317,134,1440,4,-16,138,122,24093,0,12.5,13.2,5.6,0.2,-0.7,5.7,9
28059,1634,1506,978,1417,325,128,1303,1426,146389,-5,11.2,10.3,6.7,2.2,0.9,8.9,2
28061,202,295,28,136,0,-93,28,-64,16013,1,12.6,18.4,1.7,0,-5.8,1.7,8
28063,67,101,-95,333,3,-34,-92,-126,6941,0,9.6,14.4,-13.6,0.4,-4.9,-13.1,9
28065,118,186,-40,103,-1,-68,-41,-110,10969,-1,10.7,16.9,-3.6,-0.1,-6.2,-3.7,8
28067,920,895,-263,1806,49,25,-214,-190,66250,-1,13.9,13.5,-4,0.7,0.4,-3.2,4
28069,77,126,-34,846,-2,-49,-36,-86,8584,-1,8.9,14.6,-3.9,-0.2,-5.7,-4.2,9
28071,589,479,414,5652,215,110,629,737,58467,-2,10.1,8.2,7.1,3.7,1.9,10.8,4
28073,773,523,171,373,49,250,220,471,66217,1,11.7,7.9,2.6,0.7,3.8,3.3,3
28075,825,919,-610,2871,87,-94,-523,-615,70527,2,11.6,13,-8.6,1.2,-1.3,-7.4,5
28077,159,188,10,58,-1,-29,9,-20,11741,0,13.5,16,0.9,-0.1,-2.5,0.8,8
28079,324,301,-83,374,114,23,31,55,21258,1,15.3,14.2,-3.9,5.4,1.1,1.5,8
28081,1090,1019,-164,1066,61,71,-103,-25,82799,7,13.2,12.3,-2,0.7,0.9,-1.2,5
28083,382,398,-320,899,50,-16,-270,-286,26378,0,14.4,15,-12.1,1.9,-0.6,-10.2,6
28085,408,489,1,478,17,-81,18,-62,34702,1,11.7,14.1,0,0.5,-2.3,0.5,6
28087,729,680,-481,1869,43,49,-438,-388,57283,1,12.7,11.8,-8.4,0.7,0.9,-7.6,5
28089,1276,1018,607,2385,374,258,981,1240,112511,1,11.4,9.1,5.4,3.3,2.3,8.8,2
28091,287,363,136,590,-1,-76,135,58,24224,-1,11.9,15,5.6,0,-3.1,5.6,6
28093,339,536,400,1991,13,-197,413,218,34123,2,10,15.8,11.8,0.4,-5.8,12.1,1
28095,386,501,158,445,-1,-115,157,41,33609,-1,11.5,14.9,4.7,0,-3.4,4.7,7
28097,123,155,69,117,-1,-32,68,37,9600,1,12.8,16.2,7.2,-0.1,-3.3,7.1,9
28099,431,417,-41,488,11,14,-30,-15,28789,1,15,14.5,-1.4,0.4,0.5,-1,7
28101,289,294,-6,899,5,-5,-1,-4,21019,2,13.7,14,-0.3,0.2,-0.2,0,8
28103,151,143,-94,146,0,8,-94,-86,9914,0,15.2,14.4,-9.4,0,0.8,-9.4,9
28105,490,393,-556,5641,272,97,-284,-181,51203,6,9.6,7.7,-10.8,5.3,1.9,-5.5,5
28107,379,453,151,408,0,-74,151,77,32669,0,11.6,13.9,4.6,0,-2.3,4.6,6
28109,650,778,879,1132,45,-128,924,795,57978,-1,11.3,13.5,15.3,0.8,-2.2,16,6
28111,128,196,-14,114,0,-68,-14,-83,11315,-1,11.3,17.3,-1.2,0,-6,-1.2,3
28113,516,576,-241,973,6,-60,-235,-293,39394,2,13,14.6,-6.1,0.2,-1.5,-5.9,6
28115,415,414,127,202,39,1,166,168,31535,1,13.2,13.2,4,1.2,0,5.3,9
28117,285,336,193,1313,101,-51,294,244,25135,1,11.4,13.4,7.7,4,-2,11.8,7
28119,59,127,-65,116,4,-68,-61,-128,5546,1,10.5,22.6,-11.6,0.7,-12.1,-10.9,8
28121,1740,1341,826,5659,223,399,1049,1439,160417,-9,10.9,8.4,5.2,1.4,2.5,6.6,2
28123,445,356,-280,177,140,89,-140,-53,27507,-2,16.2,12.9,-10.2,5.1,3.2,-5.1,2
28125,43,78,-91,87,0,-35,-91,-126,3336,0,12.7,22.9,-26.8,0,-10.3,-26.8,8
28127,341,361,99,481,13,-20,112,92,25715,0,13.3,14.1,3.9,0.5,-0.8,4.4,2
28129,180,203,41,145,1,-23,42,17,14099,-2,12.8,14.4,2.9,0.1,-1.6,3,8
28131,213,251,152,1249,2,-38,154,115,18756,-1,11.4,13.4,8.1,0.1,-2,8.2,2
28133,285,359,-334,4049,37,-74,-297,-369,24468,2,11.6,14.6,-13.5,1.5,-3,-12,7
28135,134,189,-200,1663,25,-55,-175,-230,11837,0,11.2,15.8,-16.7,2.1,-4.6,-14.6,9
28137,292,389,87,1323,9,-97,96,2,28261,3,10.3,13.8,3.1,0.3,-3.4,3.4,1
28139,255,306,-118,563,18,-51,-100,-151,21287,0,11.9,14.3,-5.5,0.8,-2.4,-4.7,8
28141,205,350,32,290,-2,-145,30,-114,18507,1,11,18.9,1.7,-0.1,-7.8,1.6,8
28143,111,159,-125,82,0,-48,-125,-173,9234,0,11.9,17.1,-13.4,0,-5.1,-13.4,1
28145,358,355,133,218,14,3,147,152,28284,2,12.7,12.6,4.7,0.5,0.1,5.2,7
28147,177,223,65,124,20,-46,85,39,13863,0,12.8,16.1,4.7,1.4,-3.3,6.1,9
28149,501,582,-328,452,70,-81,-258,-337,42298,2,11.8,13.7,-7.7,1.6,-1.9,-6.1,4
28151,565,631,-516,829,-1,-66,-517,-578,41946,5,13.4,14.9,-12.2,0,-1.6,-12.2,5
28153,260,278,106,84,35,-18,141,120,19703,-3,13.2,14.2,5.4,1.8,-0.9,7.2,9
28155,132,189,100,144,0,-57,100,44,9988,1,13.2,19,10,0,-5.7,10,9
28157,100,117,-126,968,0,-17,-126,-145,8058,-2,12.3,14.4,-15.5,0,-2.1,-15.5,8
28159,201,277,-16,449,4,-76,-12,-88,17416,0,11.5,15.9,-0.9,0.2,-4.4,-0.7,9
28161,136,189,27,324,0,-53,27,-27,12386,-1,11,15.2,2.2,0,-4.3,2.2,9
28163,289,335,-72,4485,21,-46,-51,-97,25796,0,11.2,13,-2.8,0.8,-1.8,-2,2
29000,68334,68389,11171,162999,7852,-55,19023,18988,6196156,20,11,11.1,1.8,1.3,0,3.1,
29001,275,256,-150,2645,101,19,-49,-29,25122,1,10.9,10.2,-6,4,0.8,-1.9,7
29003,169,183,127,129,0,-14,127,111,18127,-2,9.4,10.1,7,0,-0.8,7,3
29005,46,93,-7,86,0,-47,-7,-54,5107,0,9,18.1,-1.4,0,-9.2,-1.4,9
29007,287,331,-47,1303,0,-44,-47,-88,24394,3,11.7,13.5,-1.9,0,-1.8,-1.9,6
29009,407,488,400,230,2,-81,402,321,35265,0,11.6,13.9,11.4,0.1,-2.3,11.5,6
29011,133,166,72,20,-1,-33,71,36,11731,-2,11.4,14.2,6.1,-0.1,-2.8,6.1,8
29013,179,242,131,347,4,-63,135,72,16242,0,11,14.9,8.1,0.2,-3.9,8.3,1
29015,159,362,529,273,-5,-203,524,319,20552,-2,7.8,17.8,25.9,-0.2,-10,25.7,9
29017,130,158,41,223,0,-28,41,13,10544,0,12.3,15,3.9,0,-2.7,3.9,3
29019,1954,1339,424,10751,697,615,1121,1742,189463,6,10.4,7.1,2.2,3.7,3.3,5.9,3
29021,989,1018,-58,3631,151,-29,93,65,82956,1,11.9,12.3,-0.7,1.8,-0.3,1.1,3
29023,513,661,-72,952,1,-148,-71,-218,41948,1,12.2,15.7,-1.7,0,-3.5,-1.7,5
29025,102,131,43,216,3,-29,46,16,8955,-1,11.4,14.6,4.8,0.3,-3.2,5.1,1
29027,460,487,35,3074,1,-27,36,8,44731,-1,10.3,10.9,0.8,0,-0.6,0.8,3
29029,366,588,506,603,-2,-222,504,284,44044,2,8.3,13.4,11.5,0,-5.1,11.5,7
29031,897,871,-60,4300,83,26,23,53,82984,4,10.8,10.5,-0.7,1,0.3,0.3,3
29033,88,114,-1,108,-2,-26,-3,-29,8391,0,10.5,13.6,-0.1,-0.2,-3.1,-0.4,8
29035,84,89,55,43,-1,-5,54,49,5303,0,15.9,16.9,10.4,-0.2,-0.9,10.2,9
29037,1199,1170,1356,938,-7,29,1349,1375,111732,-3,10.8,10.5,12.2,-0.1,0.3,12.1,1
29039,213,226,84,375,-1,-13,83,71,14672,1,14.6,15.4,5.7,-0.1,-0.9,5.7,8
29041,76,119,41,228,6,-43,47,4,7399,0,10.3,16.1,5.5,0.8,-5.8,6.4,8
29043,1045,867,1074,620,54,178,1128,1300,94422,-6,11.1,9.2,11.5,0.6,1.9,12,2
29045,81,94,-63,63,0,-13,-63,-74,6641,2,12.1,14.1,-9.4,0,-1.9,-9.4,9
29047,2984,2072,1544,2260,378,912,1922,2842,259772,8,11.6,8,6,1.5,3.5,7.4,1
29049,232,254,272,384,-2,-22,270,245,21548,-3,10.8,11.9,12.7,-0.1,-1,12.6,1
29051,812,752,171,4170,92,60,263,322,77278,-1,10.5,9.8,2.2,1.2,0.8,3.4,3
29053,184,210,212,759,0,-26,212,184,16947,-2,10.9,12.5,12.6,0,-1.5,12.6,3
29055,237,377,193,470,7,-140,200,60,22719,0,10.4,16.6,8.5,0.3,-6.2,8.8,8
29057,61,125,113,175,2,-64,115,51,7716,0,7.9,16.3,14.7,0.3,-8.3,15,8
29059,211,255,218,204,8,-44,226,181,17768,-1,11.9,14.4,12.3,0.5,-2.5,12.8,2
29061,115,104,83,136,1,11,84,94,8551,-1,13.5,12.2,9.8,0.1,1.3,9.9,8
29063,97,134,-1382,772,-6,-37,-1388,-1411,9899,14,9.1,12.6,-130.3,-0.6,-3.5,-130.9,3
29065,149,257,271,193,-2,-108,269,159,14647,-2,10.2,17.6,18.6,-0.1,-7.4,18.5,9
29067,147,211,310,132,4,-64,314,247,12228,-3,12.1,17.4,25.6,0.3,-5.3,25.9,8
29069,349,480,-256,704,8,-131,-248,-379,27032,0,12.8,17.6,-9.4,0.3,-4.8,-9.1,7
29071,1090,1245,754,1052,15,-155,769,611,106404,-3,10.3,11.7,7.1,0.1,-1.5,7.2,1
29073,145,234,24,250,-1,-89,23,-67,14705,-1,9.8,15.9,1.6,-0.1,-6,1.6,8
29075,78,94,29,145,1,-16,30,13,6287,-1,12.4,15,4.6,0.2,-2.5,4.8,8
29077,3262,3247,1024,9697,363,15,1387,1414,304611,12,10.7,10.7,3.4,1.2,0,4.6,2
29079,143,154,-23,272,6,-11,-17,-29,9815,-1,14.5,15.7,-2.3,0.6,-1.1,-1.7,7
29081,84,112,25,133,7,-28,32,3,8220,-1,10.2,13.6,3,0.9,-3.4,3.9,9
29083,249,343,157,310,2,-94,159,64,22485,-1,11.1,15.3,7,0.1,-4.2,7.1,6
29085,92,188,237,171,1,-96,238,143,8718,1,10.6,21.7,27.4,0.1,-11.1,27.5,8
29087,46,76,19,88,6,-30,25,-6,4248,-1,10.8,17.9,4.5,1.4,-7.1,5.9,8
29089,95,127,-47,842,1,-32,-46,-78,10101,0,9.4,12.5,-4.6,0.1,-3.2,-4.5,3
29091,445,624,301,712,-8,-179,293,112,40735,-2,10.9,15.3,7.4,-0.2,-4.4,7.2,7
29093,86,186,123,281,6,-100,129,27,9440,-2,9.1,19.7,13,0.6,-10.6,13.7,9
29095,8531,7078,-385,11022,1262,1453,877,2342,718560,12,11.9,9.9,-0.5,1.8,2,1.2,1
29097,1579,1428,763,2428,119,151,882,1040,125056,7,12.7,11.5,6.1,1,1.2,7.1,3
29099,2281,2327,2022,1784,37,-46,2059,2010,231230,-3,9.9,10.1,8.8,0.2,-0.2,8.9,1
29101,712,494,181,3202,112,218,293,513,54962,2,13,9,3.3,2,4,5.4,4
29103,47,62,-39,106,0,-15,-39,-54,3723,0,12.5,16.5,-10.4,0,-4,-10.4,9
29105,470,494,348,378,10,-24,358,335,36680,1,12.9,13.5,9.5,0.3,-0.7,9.8,6
29107,355,436,313,833,-2,-81,311,229,33196,-1,10.7,13.2,9.5,-0.1,-2.4,9.4,1
29109,494,527,212,522,6,-33,218,183,38872,-2,12.7,13.6,5.5,0.2,-0.9,5.6,6
29111,96,144,-21,980,2,-48,-19,-68,9818,-1,9.7,14.6,-2.1,0.2,-4.9,-1.9,9
29113,813,592,1273,736,22,221,1295,1517,64699,1,12.7,9.3,19.9,0.3,3.5,20.3,1
29115,135,175,5,151,0,-40,5,-35,11791,0,11.4,14.8,0.4,0,-3.4,0.4,9
29117,156,212,274,1437,5,-56,279,222,14557,-1,10.8,14.7,19,0.3,-3.9,19.3,7
29119,342,299,175,118,89,43,264,310,23903,3,14.4,12.6,7.4,3.7,1.8,11.1,8
29121,173,213,120,200,5,-40,125,85,15161,0,11.4,14.1,7.9,0.3,-2.6,8.3,7
29123,127,208,11,415,10,-81,21,-59,12698,1,10,16.3,0.9,0.8,-6.4,1.6,9
29125,97,133,29,80,6,-36,35,-2,8430,-1,11.5,15.8,3.4,0.7,-4.3,4.2,8
29127,339,387,-126,1141,22,-48,-104,-153,28336,-1,11.9,13.6,-4.4,0.8,-1.7,-3.7,7
29129,51,50,-4,56,6,1,2,3,3469,0,14.7,14.4,-1.2,1.7,0.3,0.6,9
29131,305,320,203,353,-3,-15,200,187,25590,2,12,12.6,8,-0.1,-0.6,7.8,6
29133,144,214,226,932,0,-70,226,157,11822,1,12.3,18.2,19.2,0,-6,19.2,8
29135,199,179,-27,585,4,20,-23,-4,15256,-1,13,11.7,-1.8,0.3,1.3,-1.5,3
29137,93,123,89,134,7,-30,96,63,8698,-3,10.7,14.2,10.3,0.8,-3.5,11.1,9
29139,123,188,44,245,0,-65,44,-20,11459,1,10.7,16.4,3.8,0,-5.7,3.8,8
29141,260,322,248,343,-3,-62,245,184,21970,1,11.9,14.7,11.3,-0.1,-2.8,11.2,8
29143,188,296,-174,275,-2,-108,-176,-286,15424,-2,12.1,19,-11.2,-0.1,-6.9,-11.3,9
29145,692,753,525,1029,122,-61,647,581,60677,-5,11.5,12.5,8.7,2,-1,10.7,3
29147,214,179,-80,1928,25,35,-55,-20,20695,0,10.3,8.6,-3.9,1.2,1.7,-2.7,6
29149,106,184,96,106,1,-78,97,17,8720,-2,12.2,21.1,11,0.1,-9,11.1,9
29151,164,154,61,222,0,10,61,70,13468,-1,12.2,11.5,4.5,0,0.7,4.5,3
29153,83,161,91,51,2,-78,93,16,8970,1,9.3,18,10.2,0.2,-8.7,10.4,9
29155,181,285,-164,233,16,-104,-148,-252,14613,0,12.3,19.3,-11.1,1.1,-7.1,-10,7
29157,206,221,76,329,11,-15,87,72,18950,0,10.9,11.7,4,0.6,-0.8,4.6,6
29159,581,504,-32,995,87,77,55,133,43530,1,13.4,11.6,-0.7,2,1.8,1.3,5
29161,431,541,-44,2798,166,-110,122,11,45284,-1,9.5,11.9,-1,3.7,-2.4,2.7,5
29163,194,217,314,1552,0,-23,314,291,17935,0,10.9,12.2,17.7,0,-1.3,17.7,8
29165,1205,866,827,1232,207,339,1034,1370,111940,-3,10.8,7.8,7.4,1.9,3,9.3,1
29167,381,409,131,1171,19,-28,150,121,32780,-1,11.6,12.5,4,0.6,-0.9,4.6,2
29169,712,418,-328,10321,37,294,-291,2,53812,-1,13.2,7.8,-6.1,0.7,5.5,-5.4,5
29171,61,85,-3,59,3,-24,0,-24,4638,0,13.1,18.3,-0.6,0.6,-5.2,0,9
29173,99,134,114,92,1,-35,115,79,10489,-1,9.5,12.8,10.9,0.1,-3.3,11,9
29175,282,326,-480,1569,2,-44,-478,-517,24109,5,11.6,13.4,-19.7,0.1,-1.8,-19.6,6
29177,245,338,160,218,-2,-93,158,61,23182,-4,10.6,14.6,6.9,-0.1,-4,6.8,1
29179,59,103,-2,200,-1,-44,-3,-46,5950,1,9.9,17.2,-0.3,-0.2,-7.4,-0.5,9
29181,133,220,185,109,-3,-87,182,92,10806,-3,12.4,20.4,17.2,-0.3,-8.1,16.9,9
29183,4078,3353,1602,5439,550,725,2152,2861,416659,-16,9.8,8.1,3.9,1.3,1.7,5.2,1
29185,116,152,188,192,5,-36,193,157,9752,0,12,15.7,19.4,0.5,-3.7,20,8
29186,182,227,76,743,0,-45,76,29,18642,-2,9.8,12.2,4.1,0,-2.4,4.1,8
29187,654,903,367,6294,30,-249,397,152,67058,4,9.8,13.5,5.5,0.4,-3.7,5.9,4
29189,10035,10364,-5574,20101,2107,-329,-3467,-3732,987059,64,10.1,10.5,-5.6,2.1,-0.3,-3.5,1
29195,242,294,66,2258,33,-52,99,46,23049,-1,10.5,12.8,2.9,1.4,-2.3,4.3,7
29197,62,59,46,39,5,3,51,53,4053,-1,15.4,14.7,11.4,1.2,0.7,12.7,9
29199,83,59,5,58,-1,24,4,29,4676,1,17.8,12.7,1.1,-0.2,5.1,0.9,9
29201,467,526,73,518,5,-59,78,21,37889,2,12.3,13.9,1.9,0.1,-1.6,2.1,4
29203,87,124,59,75,1,-37,60,22,7238,-1,12,17.2,8.2,0.1,-5.1,8.3,9
29205,65,92,-42,189,6,-27,-36,-65,5931,-2,10.9,15.4,-7,1,-4.5,-6,9
29207,331,447,122,439,-1,-116,121,7,28397,2,11.7,15.7,4.3,0,-4.1,4.3,6
29209,272,465,711,273,10,-193,721,524,32658,-4,8.4,14.4,21.9,0.3,-6,22.3,6
29211,66,81,-11,117,8,-15,-3,-19,5797,-1,11.4,13.9,-1.9,1.4,-2.6,-0.5,9
29213,579,721,174,2279,-9,-142,165,26,56775,3,10.2,12.7,3.1,-0.2,-2.5,2.9,4
29215,276,388,428,1809,-2,-112,426,315,25619,1,10.8,15.2,16.8,-0.1,-4.4,16.7,9
29217,236,322,189,684,9,-86,198,111,19710,-1,12,16.4,9.6,0.5,-4.4,10.1,6
29219,440,422,493,178,-1,18,492,516,37806,6,11.7,11.2,13.1,0,0.5,13.1,1
29221,265,366,241,1018,3,-101,244,142,23534,-1,11.3,15.6,10.3,0.1,-4.3,10.4,8
29223,116,216,90,178,2,-100,92,-6,10811,2,10.7,20,8.3,0.2,-9.2,8.5,9
29225,609,464,945,724,15,145,960,1106,41472,1,14.9,11.3,23.1,0.4,3.5,23.5,2
29227,23,41,-16,35,0,-18,-16,-33,1907,1,12,21.3,-8.3,0,-9.4,-8.3,9
29229,251,291,303,202,-1,-40,302,260,19403,-2,13,15.1,15.7,-0.1,-2.1,15.7,8
29510,3415,3099,-5403,11017,698,316,-4705,-4439,281754,-50,12,10.9,-19,2.5,1.1,-16.6,1
30000,11206,11377,9485,29307,609,-171,10094,9934,1132812,11,9.9,10.1,8.4,0.5,-0.2,8.9,
30001,87,116,165,413,2,-29,167,138,9885,0,8.9,11.8,16.8,0.2,-3,17,9
30003,155,160,-68,295,-2,-5,-70,-75,12751,0,12.1,12.5,-5.3,-0.2,-0.4,-5.5,8
30005,84,69,-87,230,0,15,-87,-73,6899,-1,12.1,9.9,-12.5,0,2.2,-12.5,9
30007,84,87,261,63,2,-3,263,261,8032,1,10.6,11,33,0.3,-0.4,33.3,3
30009,76,105,199,75,12,-29,211,183,11419,1,6.7,9.3,17.6,1.1,-2.6,18.6,3
30011,14,12,14,20,0,2,14,15,1418,-1,9.9,8.5,9.9,0,1.4,9.9,9
30013,948,886,-170,3101,8,62,-162,-101,84900,-1,11.2,10.4,-2,0.1,0.7,-1.9,3
30015,34,66,-32,45,3,-32,-29,-61,5847,0,5.8,11.2,-5.4,0.5,-5.4,-4.9,8
30017,104,147,29,482,-1,-43,28,-15,11985,0,8.7,12.3,2.4,-0.1,-3.6,2.3,7
30019,15,20,-7,19,0,-5,-7,-12,1633,0,9.2,12.2,-4.3,0,-3.1,-4.3,9
30021,84,128,45,455,3,-44,48,3,8810,-1,9.5,14.5,5.1,0.3,-5,5.4,7
30023,70,123,174,580,6,-53,180,129,9673,2,7.3,12.8,18.1,0.6,-5.5,18.7,7
30025,33,33,-55,46,-1,0,-56,-56,2994,0,10.9,10.9,-18.2,-0.3,0,-18.5,9
30027,104,163,158,454,1,-59,159,100,11772,0,8.9,13.9,13.5,0.1,-5,13.6,7
30029,1157,1092,1643,1196,85,65,1728,1794,113679,1,10.3,9.7,14.6,0.8,0.6,15.3,5
30031,1266,606,686,4169,113,660,799,1471,126409,12,10.1,4.8,5.5,0.9,5.3,6.4,3
30033,19,18,-8,18,0,1,-8,-7,1211,0,15.6,14.8,-6.6,0,0.8,-6.6,9
30035,164,171,-36,539,1,-7,-35,-41,13609,1,12,12.5,-2.6,0.1,-0.5,-2.6,9
30037,5,17,22,0,0,-12,22,9,835,-1,6,20.5,26.5,0,-14.4,26.5,8
30039,29,37,107,99,0,-8,107,98,3595,-1,8.2,10.4,30.2,0,-2.3,30.2,8
30041,233,177,105,874,-3,56,102,158,16276,0,14.4,10.9,6.5,-0.2,3.5,6.3,7
30043,110,161,245,269,23,-51,268,217,13048,0,8.5,12.4,18.9,1.8,-3.9,20.7,3
30045,19,20,16,83,1,-1,17,14,2093,-2,9.1,9.6,7.7,0.5,-0.5,8.1,8
30047,311,345,514,282,3,-34,517,485,33338,2,9.4,10.4,15.5,0.1,-1,15.6,6
30049,699,689,1183,1527,36,10,1219,1227,75011,-2,9.4,9.3,15.9,0.5,0.1,16.4,3
30051,20,15,-3,260,-2,5,-5,0,1974,0,10.1,7.6,-1.5,-1,2.5,-2.5,9
30053,168,308,522,217,5,-140,527,385,21895,-2,7.7,14.2,24.1,0.2,-6.5,24.3,9
30055,26,24,-36,14,0,2,-36,-35,1676,-1,15.4,14.2,-21.3,0,1.2,-21.3,9
30057,63,103,296,69,13,-40,309,269,9521,0,6.7,11,31.5,1.4,-4.3,32.9,8
30059,22,18,42,14,0,4,42,45,2071,-1,10.7,8.8,20.5,0,2,20.5,8
30061,34,78,111,16,1,-44,112,70,5090,2,6.7,15.4,22,0.2,-8.7,22.2,3
30063,1113,940,582,3127,76,173,658,838,121849,7,9.2,7.7,4.8,0.6,1.4,5.4,3
30065,39,90,192,47,-1,-51,191,139,5308,-1,7.4,17.2,36.7,-0.2,-9.7,36.5,8
30067,138,199,208,139,4,-61,212,150,17903,-1,7.7,11.2,11.7,0.2,-3.4,11.9,6
30069,11,8,31,0,0,3,31,33,554,-1,20.5,14.9,57.7,0,5.6,57.7,9
30071,44,55,32,158,0,-11,32,21,4249,0,10.4,13,7.5,0,-2.6,7.5,9
30073,71,60,15,195,6,11,21,33,6125,1,11.6,9.8,2.5,1,1.8,3.4,9
30075,18,22,15,21,0,-4,15,11,1743,0,10.4,12.7,8.6,0,-2.3,8.6,9
30077,41,81,97,1679,-1,-40,96,55,7133,-1,5.8,11.4,13.7,-0.1,-5.6,13.5,8
30079,5,12,9,16,3,-7,12,4,1112,-1,4.5,10.8,8.1,2.7,-6.3,10.8,9
30081,408,581,719,441,15,-173,734,561,47738,0,8.6,12.2,15.2,0.3,-3.6,15.5,6
30083,144,120,-111,66,28,24,-83,-57,11173,2,12.9,10.7,-9.9,2.5,2.1,-7.4,7
30085,145,185,-181,263,4,-40,-177,-218,10319,-1,13.9,17.7,-17.4,0.4,-3.8,-17,9
30087,120,115,-19,74,23,5,4,8,8160,-1,14.7,14.1,-2.3,2.8,0.6,0.5,8
30089,109,209,397,174,2,-100,399,300,13684,1,8.1,15.4,29.3,0.1,-7.4,29.5,8
30091,34,58,-33,68,1,-24,-32,-57,3498,-1,9.6,16.4,-9.4,0.3,-6.8,-9.1,9
30093,354,496,495,1017,60,-142,555,413,36360,0,9.8,13.7,13.7,1.7,-3.9,15.4,5
30095,87,127,46,114,-2,-40,44,4,9173,0,9.5,13.8,5,-0.2,-4.4,4.8,3
30097,24,40,51,27,0,-16,51,36,3763,1,6.4,10.7,13.6,0,-4.3,13.6,8
30099,64,87,109,263,1,-23,110,84,6430,-3,10,13.6,17.1,0.2,-3.6,17.2,8
30101,49,67,59,993,14,-18,73,56,5133,1,9.6,13.1,11.6,2.7,-3.5,14.3,9
30103,9,9,19,0,0,0,19,18,772,-1,11.8,11.8,24.9,0,0,24.9,8
30105,84,89,-72,155,9,-5,-63,-68,7474,0,11.2,11.9,-9.6,1.2,-0.7,-8.4,9
30107,26,33,25,396,0,-7,25,19,2057,1,12.7,16.1,12.2,0,-3.4,12.2,9
30109,10,21,-6,27,0,-11,-6,-17,910,0,10.9,22.9,-6.5,0,-12,-6.5,9
30111,1822,1679,771,3923,58,143,829,973,170843,1,10.7,9.9,4.5,0.3,0.8,4.9,3
31000,24195,18496,-834,47479,5441,5699,4607,10319,1978379,13,12.3,9.4,-0.4,2.8,2.9,2.3,
31001,386,370,-181,902,115,16,-66,-48,30899,2,12.5,12,-5.9,3.7,0.5,-2.1,4
31003,82,72,-19,56,7,10,-12,-3,6302,-1,13,11.4,-3,1.1,1.6,-1.9,9
31005,4,5,-12,0,0,-1,-12,-13,412,0,9.6,11.9,-28.7,0,-2.4,-28.7,9
31007,6,6,16,0,1,0,17,17,674,0,9,9,24,1.5,0,25.5,8
31009,7,8,-14,0,0,-1,-14,-16,436,-1,15.8,18,-31.5,0,-2.3,-31.5,9
31011,66,79,-46,89,4,-13,-42,-56,5310,-1,12.4,14.8,-8.6,0.7,-2.4,-7.9,9
31013,110,136,-10,125,45,-26,35,9,10692,0,10.3,12.7,-0.9,4.2,-2.4,3.3,7
31015,10,39,25,30,0,-29,25,-5,1725,-1,5.8,22.6,14.5,0,-16.8,14.5,9
31017,37,41,-29,23,4,-4,-25,-30,2853,-1,12.9,14.3,-10.1,1.4,-1.4,-8.7,9
31019,606,428,-64,2361,49,178,-15,165,50697,2,12,8.5,-1.3,1,3.5,-0.3,4
31021,64,88,-20,81,1,-24,-19,-43,6727,0,9.5,13,-3,0.1,-3.6,-2.8,8
31023,96,105,26,137,0,-9,26,16,8459,-1,11.4,12.4,3.1,0,-1.1,3.1,8
31025,262,259,273,237,19,3,292,294,27446,-1,9.6,9.5,10,0.7,0.1,10.7,2
31027,84,102,-86,91,0,-18,-86,-104,8262,0,10.1,12.3,-10.3,0,-2.2,-10.3,9
31029,42,59,-26,101,12,-17,-14,-30,3724,1,11.2,15.8,-7,3.2,-4.5,-3.7,9
31031,76,56,-14,11,0,20,-14,7,5492,1,13.8,10.2,-2.6,0,3.6,-2.6,9
31033,103,129,26,77,15,-26,41,15,9541,0,10.8,13.5,2.7,1.6,-2.7,4.3,7
31035,79,81,66,61,6,-2,72,67,6116,-3,13,13.3,10.9,1,-0.3,11.8,9
31037,158,66,-197,48,220,92,23,113,10566,-2,15,6.3,-18.7,20.9,8.8,2.2,7
31039,121,113,-56,80,13,8,-43,-35,8918,0,13.5,12.6,-6.3,1.5,0.9,-4.8,9
31041,130,132,81,93,0,-2,81,77,10581,-2,12.3,12.5,7.7,0,-0.2,7.7,9
31043,375,180,-206,199,163,195,-43,152,21268,0,17.7,8.5,-9.7,7.7,9.2,-2,3
31045,80,105,-91,723,-2,-25,-93,-119,8133,-1,9.8,12.8,-11.1,-0.2,-3.1,-11.4,9
31047,369,241,-198,210,247,128,49,180,24085,3,15.4,10,-8.3,10.3,5.3,2,7
31049,20,23,-26,0,0,-3,-26,-30,1871,-1,10.6,12.2,-13.8,0,-1.6,-13.8,9
31051,60,63,-44,78,23,-3,-21,-25,5491,-1,10.9,11.4,-8,4.2,-0.5,-3.8,8
31053,489,448,63,667,37,41,100,142,37187,1,13.2,12.1,1.7,1,1.1,2.7,4
31055,7842,4562,-1927,11950,2066,3280,139,3434,589540,15,13.3,7.8,-3.3,3.5,5.6,0.2,2
31057,18,15,-37,21,0,3,-37,-34,1561,0,11.4,9.5,-23.4,0,1.9,-23.4,9
31059,61,87,32,123,0,-26,32,7,5548,1,11,15.7,5.8,0,-4.7,5.8,8
31061,24,49,0,24,0,-25,0,-25,2825,0,8.5,17.3,0,0,-8.8,0,9
31063,19,32,-11,118,0,-13,-11,-26,2585,-2,7.3,12.3,-4.2,0,-5,-4.2,9
31065,56,57,-17,45,5,-1,-12,-14,4556,-1,12.3,12.5,-3.7,1.1,-0.2,-2.6,9
31067,206,337,195,414,9,-131,204,70,21634,-3,9.5,15.6,9,0.4,-6.1,9.4,6
31069,17,36,-21,25,0,-19,-21,-41,1794,-1,9.4,19.8,-11.6,0,-10.5,-11.6,9
31071,22,40,-5,71,0,-18,-5,-24,1763,-1,12.4,22.5,-2.8,0,-10.1,-2.8,9
31073,17,25,21,32,0,-8,21,12,1847,-1,9.2,13.6,11.4,0,-4.3,11.4,9
31075,8,2,-25,3,0,6,-25,-19,565,0,13.9,3.5,-43.5,0,10.4,-43.5,9
31077,26,25,-16,23,0,1,-16,-16,2219,-1,11.7,11.2,-7.2,0,0.4,-7.2,8
31079,923,603,-557,1027,333,320,-224,101,62197,5,14.9,9.7,-9,5.4,5.1,-3.6,3
31081,108,108,100,96,0,0,100,98,9537,-2,11.4,11.4,10.5,0,0,10.5,8
31083,32,56,37,49,3,-24,40,13,3045,-3,10.5,18.4,12.2,1,-7.9,13.2,9
31085,10,8,-27,0,7,2,-20,-18,846,0,11.7,9.4,-31.6,8.2,2.3,-23.4,9
31087,29,45,-47,33,0,-16,-47,-62,2552,1,11.2,17.4,-18.2,0,-6.2,-18.2,9
31089,129,123,39,109,35,6,74,80,10093,0,12.8,12.2,3.9,3.5,0.6,7.4,9
31091,6,11,2,3,0,-5,2,-3,679,0,8.8,16.2,2.9,0,-7.3,2.9,9
31093,78,89,23,111,6,-11,29,18,6527,0,12,13.7,3.5,0.9,-1.7,4.4,3
31095,78,124,-46,104,5,-46,-41,-86,7054,1,11,17.5,-6.5,0.7,-6.5,-5.8,9
31097,37,67,-26,1108,9,-30,-17,-47,5198,0,7.1,12.8,-5,1.7,-5.7,-3.3,8
31099,80,73,32,63,24,7,56,64,6770,1,11.9,10.8,4.7,3.6,1,8.3,9
31101,81,130,-16,49,0,-49,-16,-66,8113,-1,9.9,16,-2,0,-6,-2,9
31103,5,6,1,0,0,-1,1,0,805,0,6.2,7.5,1.2,0,-1.2,1.2,9
31105,26,49,-32,69,9,-23,-23,-47,3289,-1,7.8,14.8,-9.7,2.7,-6.9,-6.9,8
31107,83,120,27,118,3,-37,30,-9,8298,-2,10,14.5,3.3,0.4,-4.5,3.6,9
31109,3664,2529,43,13244,1088,1135,1131,2282,326716,16,11.3,7.8,0.1,3.3,3.5,3.5,2
31111,343,481,-127,595,15,-138,-112,-249,33365,1,10.2,14.4,-3.8,0.4,-4.1,-3.3,5
31113,6,4,-34,0,1,2,-33,-30,655,1,9,6,-50.7,1.5,3,-49.3,9
31115,3,5,-6,0,0,-2,-6,-9,592,-1,5,8.4,-10.1,0,-3.4,-10.1,9
31117,4,0,-1,0,0,4,-1,4,383,1,10.5,0,-2.6,0,10.5,-2.6,9
31119,466,368,80,1417,35,98,115,213,35627,0,13.1,10.4,2.3,1,2.8,3.2,5
31121,86,98,45,157,8,-12,53,40,7755,-1,11.1,12.7,5.8,1,-1.6,6.9,3
31123,57,74,-6,94,5,-17,-1,-18,4504,0,12.6,16.4,-1.3,1.1,-3.8,-0.2,9
31125,38,57,-24,102,0,-19,-24,-43,3274,0,11.5,17.3,-7.3,0,-5.8,-7.3,8
31127,82,95,53,467,1,-13,54,40,7076,-1,11.6,13.5,7.5,0.1,-1.8,7.7,9
31129,43,57,41,45,0,-14,41,26,4095,-1,10.5,14,10,0,-3.4,10,9
31131,197,200,71,243,81,-3,152,149,16335,0,12.1,12.3,4.4,5,-0.2,9.3,6
31133,31,43,-9,30,2,-12,-7,-19,2512,0,12.3,17.1,-3.6,0.8,-4.8,-2.8,9
31135,24,38,-32,0,13,-14,-19,-32,2795,1,8.5,13.5,-11.4,4.6,-5,-6.8,9
31137,117,114,60,205,7,3,67,69,9057,-1,13,12.6,6.7,0.8,0.3,7.4,7
31139,93,77,-55,72,20,16,-35,-18,7299,1,12.7,10.5,-7.5,2.7,2.2,-4.8,9
31141,454,306,-55,353,161,148,106,254,34609,0,13.2,8.9,-1.6,4.7,4.3,3.1,5
31143,54,76,-4,93,16,-22,12,-12,5228,-2,10.3,14.5,-0.8,3.1,-4.2,2.3,8
31145,108,163,-19,302,3,-55,-16,-71,10457,0,10.3,15.5,-1.8,0.3,-5.2,-1.5,7
31147,71,121,8,150,-1,-50,7,-41,7689,2,9.2,15.7,1,-0.1,-6.5,0.9,9
31149,15,25,39,31,0,-10,39,30,1271,1,11.9,19.9,31.1,0,-8,31.1,9
31151,172,134,-91,858,59,38,-32,7,14555,1,11.8,9.2,-6.3,4.1,2.6,-2.2,6
31153,2363,1278,2069,1247,301,1085,2370,3459,199886,4,11.9,6.4,10.4,1.5,5.5,12,2
31155,244,241,280,335,5,3,285,286,23463,-2,10.5,10.3,12,0.2,0.1,12.2,2
31157,433,434,-146,1012,77,-1,-69,-70,35699,0,12.1,12.1,-4.1,2.2,0,-1.9,5
31159,172,191,63,1282,2,-19,65,46,17671,0,9.7,10.8,3.6,0.1,-1.1,3.7,2
31161,46,71,-57,156,4,-25,-53,-78,4928,0,9.3,14.3,-11.5,0.8,-5,-10.7,9
31163,32,39,-17,50,0,-7,-17,-23,2983,1,10.7,13,-5.7,0,-2.3,-5.7,8
31165,12,13,23,0,5,-1,28,27,1154,0,10.5,11.4,20.2,4.4,-0.9,24.6,9
31167,62,46,77,73,0,16,77,91,5856,-2,10.7,7.9,13.3,0,2.8,13.3,9
31169,50,88,13,90,1,-38,14,-25,4829,-1,10.3,18.2,2.7,0.2,-7.8,2.9,9
31171,8,11,16,0,0,-3,16,12,677,-1,11.9,16.4,23.8,0,-4.5,23.8,9
31173,132,109,-28,101,6,23,-22,2,6557,1,20.1,16.6,-4.3,0.9,3.5,-3.4,8
31175,51,57,-38,29,0,-6,-38,-46,4012,-2,12.6,14.1,-9.4,0,-1.5,-9.4,9
31177,205,211,-21,153,12,-6,-9,-15,21152,0,9.7,10,-1,0.6,-0.3,-0.4,2
31179,107,72,-70,1319,10,35,-60,-25,9874,0,10.8,7.3,-7.1,1,3.5,-6.1,7
31181,33,64,42,67,0,-31,42,12,3351,1,9.9,19.1,12.6,0,-9.3,12.6,9
31183,13,8,-11,0,0,5,-11,-7,775,-1,16.7,10.3,-14.1,0,6.4,-14.1,9
31185,161,185,58,839,11,-24,69,44,14356,-1,11.2,12.9,4,0.8,-1.7,4.8,6
32000,33055,29322,8642,35093,4266,3733,12908,16755,3194176,114,10.4,9.2,2.7,1.3,1.2,4.1,
32001,280,376,106,387,-4,-96,102,5,25803,-1,10.9,14.6,4.1,-0.2,-3.7,4,6
32003,24876,20042,5404,19667,3693,4834,9097,14038,2336573,107,10.7,8.6,2.3,1.6,2.1,3.9,1
32005,326,613,172,223,-2,-287,170,-117,49545,0,6.6,12.4,3.5,0,-5.8,3.4,4
32007,566,495,253,612,-15,71,238,314,54293,5,10.5,9.1,4.7,-0.3,1.3,4.4,5
32009,3,12,-3,1,1,-9,-2,-11,736,0,4,16.2,-4,1.3,-12.1,-2.7,9
32011,18,28,59,0,6,-10,65,54,1917,-1,9.5,14.8,31.2,3.2,-5.3,34.4,9
32013,198,202,-162,69,7,-4,-155,-160,17136,-1,11.5,11.7,-9.4,0.4,-0.2,-9,7
32015,60,74,23,42,-1,-14,22,8,5769,0,10.4,12.8,4,-0.2,-2.4,3.8,9
32017,30,69,51,210,0,-39,51,12,4452,0,6.7,15.5,11.5,0,-8.8,11.5,8
32019,633,835,1188,255,-30,-202,1158,955,62583,-1,10.2,13.4,19.1,-0.5,-3.3,18.6,2
32021,35,88,45,57,-1,-53,44,-9,4528,0,7.7,19.4,9.9,-0.2,-11.7,9.7,8
32023,368,991,1592,1375,-21,-623,1571,951,55720,3,6.7,17.9,28.8,-0.4,-11.3,28.4,4
32027,50,90,-51,1438,5,-40,-46,-86,6364,0,7.8,14,-8,0.8,-6.2,-7.2,8
32029,18,49,45,0,0,-31,45,12,4177,-2,4.3,11.7,10.8,0,-7.4,10.8,2
32031,5003,4333,-241,7282,613,670,372,1042,498022,0,10.1,8.7,-0.5,1.2,1.3,0.7,2
32033,67,111,-178,540,-3,-44,-181,-224,8522,1,7.8,12.9,-20.6,-0.3,-5.1,-21,9
32510,524,914,339,2935,18,-390,357,-29,58036,4,9,15.7,5.8,0.3,-6.7,6.1,3
33000,12155,14264,4298,41525,859,-2109,5157,3051,1402054,3,8.7,10.2,3.1,0.6,-1.5,3.7,
33001,458,831,717,898,-21,-373,696,322,65027,-1,7.1,12.8,11.1,-0.3,-5.8,10.7,4
33003,310,658,638,567,4,-348,642,294,52448,0,5.9,12.6,12.2,0.1,-6.7,12.3,6
33005,656,883,463,3560,5,-227,468,240,77703,-1,8.5,11.4,6,0.1,-2.9,6,4
33007,224,569,240,1415,1,-345,241,-104,31372,0,7.1,18.1,7.6,0,-11,7.7,7
33009,662,978,250,7570,82,-316,332,15,93146,-1,7.1,10.5,2.7,0.9,-3.4,3.6,5
33011,4170,3952,-956,8463,593,218,-363,-139,427354,6,9.8,9.2,-2.2,1.4,0.5,-0.8,2
33013,1298,1603,884,7633,60,-305,944,644,157103,5,8.3,10.2,5.6,0.4,-1.9,6,4
33015,2877,2945,1053,2720,80,-68,1133,1056,320689,-9,9,9.2,3.3,0.2,-0.2,3.5,1
33017,1155,1309,787,7907,36,-154,823,672,133243,3,8.7,9.8,5.9,0.3,-1.2,6.2,1
33019,345,536,222,792,19,-191,241,51,43969,1,7.9,12.2,5.1,0.4,-4.3,5.5,7
34000,102055,76563,-44666,168097,49298,25492,4632,30024,9290841,-100,11,8.3,-4.8,5.3,2.7,0.5,
34001,2779,2998,-881,5781,924,-219,43,-169,275213,7,10.1,10.9,-3.2,3.4,-0.8,0.2,2
34003,9117,6960,-2728,10601,4778,2157,2050,4196,957736,-11,9.5,7.3,-2.9,5,2.3,2.1,1
34005,4731,4254,1751,11304,849,477,2600,3066,469167,-11,10.1,9.1,3.7,1.8,1,5.6,1
34007,6227,5011,152,6432,1171,1216,1323,2547,527196,8,11.8,9.5,0.3,2.2,2.3,2.5,1
34009,744,1383,-188,1330,37,-639,-151,-795,94610,-5,7.8,14.6,-2,0.4,-6.7,-1.6,2
34011,1857,1717,382,9187,447,140,829,979,152326,10,12.2,11.3,2.5,2.9,0.9,5.5,3
34013,9950,6183,-9874,24634,7484,3767,-2390,1393,851117,16,11.7,7.3,-11.6,8.8,4.4,-2.8,1
34015,3057,2884,1178,7626,323,173,1501,1656,308423,-18,9.9,9.4,3.8,1.1,0.6,4.9,1
34017,8855,3986,-10956,7920,9343,4869,-1613,3091,705472,-165,12.6,5.7,-15.6,13.3,6.9,-2.3,1
34019,1116,1004,68,2972,214,112,282,378,130183,-16,8.6,7.7,0.5,1.6,0.9,2.2,1
34021,4130,3145,-2892,15396,2761,985,-131,892,381671,38,10.8,8.2,-7.6,7.2,2.6,-0.3,2
34023,8603,6134,-7000,22266,7001,2469,1,2529,863623,59,10,7.1,-8.1,8.1,2.9,0,1
34025,6315,5769,-2915,6785,924,546,-1991,-1429,642799,16,9.8,9,-4.5,1.4,0.8,-3.1,1
34027,5024,3951,135,8170,2013,1073,2148,3204,514423,-17,9.8,7.7,0.3,3.9,2.1,4.2,1
34029,10251,7528,200,6604,628,2723,828,3534,659197,-17,15.6,11.5,0.3,1,4.1,1.3,1
34031,6332,3852,-6396,9175,3661,2480,-2735,-239,513395,16,12.3,7.5,-12.5,7.1,4.8,-5.3,1
34033,721,808,229,768,41,-87,270,181,65338,-2,11.1,12.4,3.5,0.6,-1.3,4.1,1
34035,3190,2494,-641,3975,1750,696,1109,1795,348842,-10,9.2,7.2,-1.8,5,2,3.2,1
34037,1416,1358,392,464,121,58,513,557,146132,-14,9.7,9.3,2.7,0.8,0.4,3.5,1
34039,6624,4013,-4975,5213,4646,2611,-329,2309,572726,27,11.6,7,-8.7,8.1,4.6,-0.6,1
34041,1016,1131,293,1494,182,-115,475,349,111252,-11,9.1,10.2,2.6,1.6,-1,4.3,2
35000,20728,22344,-1088,43081,3642,-1616,2554,895,2114371,-43,9.8,10.6,-0.5,1.7,-0.8,1.2,
35001,6473,6250,-3170,11219,1603,223,-1567,-1371,671586,-27,9.6,9.3,-4.7,2.4,0.3,-2.3,2
35003,22,73,68,41,15,-51,83,32,3825,0,5.8,19.2,17.9,3.9,-13.4,21.8,9
35005,738,764,-395,2121,88,-26,-307,-331,63561,2,11.6,12,-6.2,1.4,-0.4,-4.8,5
35006,225,368,33,2253,17,-143,50,-91,26780,2,8.4,13.7,1.2,0.6,-5.3,1.9,6
35007,85,175,48,632,25,-90,73,-17,12255,0,6.9,14.3,3.9,2,-7.3,6,7
35009,754,531,-479,833,53,223,-426,-208,47222,-5,15.9,11.2,-10.1,1.1,4.7,-9,5
35011,14,39,-10,2,0,-25,-10,-35,1657,0,8.4,23.3,-6,0,-14.9,-6,9
35013,2285,2008,1049,4612,342,277,1391,1680,225210,12,10.2,8.9,4.7,1.5,1.2,6.2,3
35015,734,726,41,945,25,8,66,72,60275,-2,12.2,12.1,0.7,0.4,0.1,1.1,5
35017,214,405,-55,661,29,-191,-26,-221,27472,-4,7.8,14.7,-2,1.1,-6.9,-0.9,7
35019,23,59,2,612,10,-36,12,-24,4292,0,5.3,13.7,0.5,2.3,-8.4,2.8,9
35021,0,15,18,0,1,-15,19,3,624,-1,0,24.1,28.9,1.6,-24.1,30.5,9
35023,43,61,-30,72,3,-18,-27,-46,3965,-1,10.8,15.3,-7.5,0.8,-4.5,-6.8,9
35025,810,688,-590,2134,223,122,-367,-242,72101,3,11.2,9.5,-8.2,3.1,1.7,-5.1,5
35027,181,306,-174,115,-11,-125,-185,-314,20029,-4,9,15.2,-8.6,-0.5,-6.2,-9.2,7
35028,170,135,6,65,130,35,136,171,19444,0,8.8,7,0.3,6.7,1.8,7,6
35029,326,403,-338,788,39,-77,-299,-377,25316,-1,12.8,15.8,-13.3,1.5,-3,-11.7,6
35031,756,905,-1053,875,66,-149,-987,-1134,68797,2,10.9,13,-15.2,1,-2.1,-14.2,5
35033,28,56,5,2,0,-28,5,-24,4123,-1,6.8,13.5,1.2,0,-6.8,1.2,8
35035,687,774,170,3659,232,-87,402,318,68835,3,10,11.3,2.5,3.4,-1.3,5.9,4
35037,62,164,86,55,0,-102,86,-19,8510,-3,7.3,19.2,10.1,0,-12,10.1,7
35039,405,535,-54,216,71,-130,17,-115,39876,-2,10.1,13.4,-1.4,1.8,-3.3,0.4,6
35041,228,208,-77,1032,-14,20,-91,-71,18787,0,12.1,11.1,-4.1,-0.7,1.1,-4.8,7
35043,1307,1378,2280,1050,134,-71,2414,2339,155936,-4,8.4,8.9,14.7,0.9,-0.5,15.6,2
35045,1326,1490,195,1311,72,-164,267,106,120675,3,11,12.4,1.6,0.6,-1.4,2.2,3
35047,223,371,-126,1056,39,-148,-87,-234,26668,1,8.3,13.9,-4.7,1.5,-5.5,-3.2,6
35049,1129,1418,156,2690,337,-289,493,195,155956,-9,7.2,9.1,1,2.2,-1.9,3.2,3
35051,67,269,221,174,-2,-202,219,14,11488,-3,5.8,23.4,19.2,-0.2,-17.6,19.1,6
35053,152,212,-90,849,1,-60,-89,-148,15963,1,9.5,13.2,-5.6,0.1,-3.7,-5.5,6
35055,235,394,-46,234,22,-159,-24,-185,34405,-2,6.8,11.4,-1.3,0.6,-4.6,-0.7,7
35057,154,238,336,296,0,-84,336,250,15633,-2,9.9,15.3,21.7,0,-5.4,21.7,2
35059,35,59,7,450,0,-24,7,-18,3964,-1,8.8,14.9,1.8,0,-6,1.8,9
35061,837,867,878,2027,92,-30,970,940,79141,0,10.6,11,11.2,1.2,-0.4,12.3,2
36000,207450,165914,-216778,616970,73867,41536,-142911,-101984,19571216,-609,10.6,8.5,-11,3.8,2.1,-7.3,
36001,2861,2943,-328,19426,1140,-82,812,738,316659,8,9,9.3,-1,3.6,-0.3,2.6,2
36003,496,540,-54,5221,22,-44,-32,-75,46651,1,10.6,11.6,-1.2,0.5,-0.9,-0.7,7
36005,16614,10648,-41473,53988,10224,5966,-31249,-25332,1356476,-49,12.1,7.8,-30.3,7.5,4.4,-22.8,1
36007,1873,2326,-1189,13152,455,-453,-734,-1181,196077,6,9.5,11.8,-6,2.3,-2.3,-3.7,3
36009,791,1102,-170,2754,27,-311,-143,-450,75600,4,10.4,14.5,-2.2,0.4,-4.1,-1.9,4
36011,669,877,-13,3305,27,-208,14,-194,74485,0,9,11.8,-0.2,0.4,-2.8,0.2,4
36013,1273,1765,-29,4653,70,-492,41,-453,124891,-2,10.2,14.1,-0.2,0.6,-3.9,0.3,4
36015,820,1073,-150,3240,87,-253,-63,-316,81325,0,10.1,13.2,-1.8,1.1,-3.1,-0.8,3
36017,473,650,-239,796,2,-177,-237,-411,45920,3,10.3,14.1,-5.2,0,-3.8,-5.1,6
36019,676,813,139,4682,74,-137,213,78,78115,2,8.7,10.4,1.8,0.9,-1.8,2.7,4
36021,463,721,-430,1860,51,-258,-379,-638,60470,-1,7.6,11.9,-7.1,0.8,-4.2,-6.2,6
36023,419,536,-229,4080,17,-117,-212,-329,45752,0,9.1,11.7,-5,0.4,-2.5,-4.6,4
36025,354,634,-100,2474,18,-280,-82,-364,44410,-2,7.9,14.2,-2.2,0.4,-6.3,-1.8,8
36027,2726,2896,-800,18231,504,-170,-296,-459,297150,7,9.2,9.7,-2.7,1.7,-0.6,-1,2
36029,9592,9885,-4097,27135,2074,-293,-2023,-2276,946147,40,10.1,10.4,-4.3,2.2,-0.3,-2.1,1
36031,267,467,175,1676,39,-200,214,12,36775,-2,7.3,12.7,4.8,1.1,-5.4,5.8,6
36033,451,540,167,3120,29,-89,196,109,46502,2,9.7,11.6,3.6,0.6,-1.9,4.2,7
36035,481,757,237,1056,16,-276,253,-22,52234,1,9.2,14.5,4.5,0.3,-5.3,4.8,4
36037,542,691,272,2012,10,-149,282,131,57529,-2,9.4,12,4.7,0.2,-2.6,4.9,4
36039,393,617,-78,2409,22,-224,-56,-283,47062,-3,8.3,13.1,-1.7,0.5,-4.7,-1.2,6
36041,27,78,15,122,-2,-51,13,-39,5082,-1,5.3,15.3,2.9,-0.4,-10,2.5,8
36043,563,776,99,1292,16,-213,115,-100,59484,-2,9.5,13,1.7,0.3,-3.6,1.9,2
36045,1856,1023,-1772,6602,273,833,-1499,-674,114787,-8,16.1,8.9,-15.4,2.4,7.2,-13,3
36047,31066,16892,-55308,45473,13292,14174,-42016,-28306,2561225,-464,12.1,6.6,-21.5,5.2,5.5,-16.3,1
36049,289,299,-44,283,7,-10,-37,-47,26548,0,10.9,11.3,-1.7,0.3,-0.4,-1.4,8
36051,518,642,-114,4538,55,-124,-59,-182,61158,1,8.5,10.5,-1.9,0.9,-2,-1,1
36053,546,684,-40,4630,44,-138,4,-133,66921,1,8.2,10.2,-0.6,0.7,-2.1,0.1,2
36055,7776,7332,-4457,27492,1584,444,-2873,-2405,748482,24,10.4,9.8,-5.9,2.1,0.6,-3.8,1
36057,603,704,111,1252,27,-101,138,35,49368,-2,12.2,14.3,2.2,0.5,-2,2.8,4
36059,14213,10994,-9618,22314,2743,3219,-6875,-3579,1381715,77,10.3,7.9,-7,2,2.3,-5,1
36061,13309,10288,-10303,76930,10499,3021,196,2908,1597451,-309,8.3,6.4,-6.5,6.6,1.9,0.1,1
36063,2001,2746,-431,3841,161,-745,-270,-1010,209457,5,9.5,13.1,-2.1,0.8,-3.5,-1.3,1
36065,2481,2788,-939,11222,438,-307,-501,-803,227555,5,10.9,12.2,-4.1,1.9,-1.3,-2.2,2
36067,4930,4744,-3179,19734,1118,186,-2061,-1855,467873,20,10.5,10.1,-6.8,2.4,0.4,-4.4,2
36069,983,1118,47,3664,102,-135,149,13,112494,-1,8.7,9.9,0.4,0.9,-1.2,1.3,1
36071,5585,2933,-2466,13465,760,2652,-1706,979,407470,33,13.7,7.2,-6.1,1.9,6.5,-4.2,2
36073,391,465,-1,1382,37,-74,36,-39,39124,-1,10,11.9,0,0.9,-1.9,0.9,1
36075,1148,1242,-42,5448,58,-94,16,-77,118162,1,9.7,10.5,-0.4,0.5,-0.8,0.1,2
36077,483,691,-122,8149,46,-208,-76,-283,60126,1,8,11.5,-2,0.8,-3.5,-1.3,7
36079,926,723,-588,2323,131,203,-457,-252,98060,2,9.4,7.4,-6,1.3,2.1,-4.7,1
36081,23304,15544,-50161,35103,16290,7760,-33871,-26362,2252196,-251,10.3,6.9,-22.1,7.2,3.4,-15,1
36083,1496,1674,-267,6826,330,-178,63,-116,159305,-1,9.4,10.5,-1.7,2.1,-1.1,0.4,2
36085,4920,4046,-2767,7265,1200,874,-1567,-671,490687,22,10,8.2,-5.6,2.4,1.8,-3.2,1
36087,6236,2311,-4460,6414,937,3925,-3523,450,340807,48,18.3,6.8,-13.1,2.8,11.5,-10.3,1
36089,1022,1193,-104,10040,125,-171,21,-149,106940,1,9.6,11.1,-1,1.2,-1.6,0.2,4
36091,2122,2177,72,3756,224,-55,296,243,238711,2,8.9,9.1,0.3,0.9,-0.2,1.2,2
36093,1835,1730,-210,6254,310,105,100,208,159902,3,11.5,10.8,-1.3,1.9,0.7,0.6,2
36095,267,350,90,1424,8,-83,98,14,30105,-1,8.9,11.6,3,0.3,-2.8,3.3,2
36097,177,258,-22,218,2,-81,-20,-102,17507,-1,10.1,14.7,-1.3,0.1,-4.6,-1.1,8
36099,343,397,-200,1313,17,-54,-183,-237,32349,0,10.6,12.2,-6.2,0.5,-1.7,-5.6,6
36101,993,1185,-235,1456,81,-192,-154,-343,92162,3,10.8,12.8,-2.5,0.9,-2.1,-1.7,4
36103,16113,12881,-11561,35299,3416,3232,-8145,-4804,1523170,109,10.6,8.4,-7.6,2.2,2.1,-5.3,1
36105,995,850,-93,4250,134,145,41,185,79920,-1,12.5,10.6,-1.2,1.7,1.8,0.5,6
36107,464,531,19,647,-1,-67,18,-51,47715,-2,9.7,11.1,0.4,0,-1.4,0.4,3
36109,699,718,-1263,14612,532,-19,-731,-741,103558,9,6.7,6.9,-12.2,5.1,-0.2,-7,3
36111,1576,1894,102,12247,229,-318,331,13,182333,0,8.6,10.4,0.6,1.3,-1.7,1.8,3
36113,525,823,235,1094,20,-298,255,-47,65380,-4,8,12.6,3.6,0.3,-4.6,3.9,3
36115,562,738,-617,2212,27,-176,-590,-763,60047,3,9.3,12.2,-10.2,0.4,-2.9,-9.8,3
36117,900,984,-67,1176,18,-84,-49,-129,90829,4,9.9,10.8,-0.7,0.2,-0.9,-0.5,1
36119,10278,7313,-7565,25748,3628,2965,-3937,-919,990817,53,10.4,7.4,-7.6,3.7,3,-4,1
36121,350,403,-50,3038,33,-53,-17,-69,39532,1,8.8,10.2,-1.3,0.8,-1.3,-0.4,8
36123,345,271,-113,1152,10,74,-103,-30,24472,-1,14.1,11.1,-4.6,0.4,3,-4.2,6
37000,121148,108491,97264,281967,29448,12657,126712,139526,10835491,157,11.3,10.1,9,2.7,1.2,11.8,
37001,1944,1926,2208,5880,315,18,2523,2547,179165,6,10.9,10.8,12.4,1.8,0.1,14.2,3
37003,352,502,308,1209,-2,-150,306,157,36473,1,9.7,13.8,8.5,-0.1,-4.1,8.4,2
37005,102,167,214,246,1,-65,215,149,11342,-1,9.1,14.8,19,0.1,-5.8,19.1,9
37007,267,367,33,1676,6,-100,39,-61,21897,0,12.2,16.7,1.5,0.3,-4.6,1.8,1
37009,205,434,214,433,17,-229,231,1,27063,-1,7.6,16,7.9,0.6,-8.5,8.5,9
37011,137,239,82,2048,39,-102,121,20,17561,1,7.8,13.6,4.7,2.2,-5.8,6.9,9
37013,443,683,295,379,25,-240,320,81,44481,1,10,15.4,6.6,0.6,-5.4,7.2,6
37015,152,304,9,1342,-1,-152,8,-146,16922,-2,8.9,17.9,0.5,-0.1,-8.9,0.5,9
37017,349,507,255,320,-2,-158,253,93,29484,-2,11.9,17.2,8.7,-0.1,-5.4,8.6,8
37019,1127,1921,7796,942,25,-794,7821,7056,159964,29,7.2,12.3,49.8,0.2,-5.1,50,2
37021,2432,2901,2051,7917,512,-469,2563,2111,275901,17,8.8,10.6,7.5,1.9,-1.7,9.3,2
37023,861,1227,697,2949,36,-366,733,366,88338,-1,9.8,13.9,7.9,0.4,-4.2,8.3,2
37025,2723,1893,2942,1779,345,830,3287,4107,240016,-10,11.4,8,12.4,1.4,3.5,13.8,1
37027,753,1228,696,1123,5,-475,701,227,80574,1,9.4,15.3,8.7,0.1,-5.9,8.7,2
37029,77,111,74,10,7,-34,81,47,11137,0,6.9,10,6.7,0.6,-3.1,7.3,1
37031,488,990,762,825,31,-502,793,289,69615,-2,7,14.3,11,0.4,-7.2,11.4,4
37033,192,355,540,1335,4,-163,544,376,22807,-5,8.5,15.7,23.9,0.2,-7.2,24.1,8
37035,1670,2019,1626,2719,195,-349,1821,1478,164645,6,10.2,12.3,9.9,1.2,-2.1,11.1,2
37037,689,828,1676,784,153,-139,1829,1685,81624,-5,8.5,10.2,20.7,1.9,-1.7,22.6,2
37039,285,481,700,341,-3,-196,697,500,29959,-1,9.6,16.2,23.6,-0.1,-6.6,23.5,9
37041,137,240,99,273,-2,-103,97,-7,13891,-1,9.9,17.3,7.1,-0.1,-7.4,7,8
37043,90,169,326,91,2,-79,328,249,11864,0,7.7,14.4,27.8,0.2,-6.7,27.9,9
37045,1127,1427,999,1962,26,-300,1025,725,101378,0,11.2,14.1,9.9,0.3,-3,10.1,4
37047,583,823,280,2490,3,-240,283,46,50121,3,11.6,16.4,5.6,0.1,-4.8,5.6,6
37049,1257,1287,1192,3344,136,-30,1328,1304,102391,6,12.4,12.7,11.7,1.3,-0.3,13.1,4
37051,5281,3231,-2125,16148,1175,2050,-950,1109,337890,9,15.7,9.6,-6.3,3.5,6.1,-2.8,2
37053,290,288,589,135,-6,2,583,585,31593,0,9.3,9.2,18.8,-0.2,0.1,18.6,1
37055,283,395,169,264,64,-112,233,123,38110,2,7.4,10.4,4.4,1.7,-2.9,6.1,4
37057,1779,2174,2616,1879,200,-395,2816,2424,174804,3,10.2,12.5,15.1,1.2,-2.3,16.2,2
37059,420,569,613,415,23,-149,636,484,44599,-3,9.5,12.8,13.8,0.5,-3.4,14.3,2
37061,720,656,293,424,229,64,522,586,49520,0,14.6,13.3,6,4.7,1.3,10.6,8
37063,4190,2280,-615,17793,2338,1910,1723,3600,336892,-33,12.5,6.8,-1.8,7,5.7,5.1,2
37065,592,716,521,653,52,-124,573,443,48832,-6,12.2,14.7,10.7,1.1,-2.6,11.8,3
37067,4504,3955,1798,11516,900,549,2698,3260,392921,13,11.5,10.1,4.6,2.3,1.4,6.9,2
37069,846,735,2406,1270,86,111,2492,2601,77001,-2,11.2,9.7,31.8,1.1,1.5,32.9,1
37071,2752,2822,3020,3408,307,-70,3327,3272,237242,15,11.7,12,12.8,1.3,-0.3,14.1,1
37073,86,159,51,117,-4,-73,47,-27,10343,-1,8.3,15.4,4.9,-0.4,-7,4.5,1
37075,96,115,31,238,9,-19,40,20,8052,-1,11.9,14.3,3.9,1.1,-2.4,5,9
37077,644,689,522,3843,14,-45,536,490,62192,-1,10.4,11.1,8.4,0.2,-0.7,8.7,6
37079,199,235,168,3413,31,-36,199,163,20530,0,9.7,11.5,8.2,1.5,-1.8,9.7,8
37081,5862,5185,661,25871,2068,677,2729,3409,549866,3,10.7,9.5,1.2,3.8,1.2,5,2
37083,528,785,-198,1242,45,-257,-153,-413,47298,-3,11.1,16.5,-4.2,0.9,-5.4,-3.2,4
37085,1858,1299,2212,2891,210,559,2422,2999,141477,18,13.3,9.3,15.8,1.5,4,17.3,4
37087,519,964,775,911,18,-445,793,354,62969,6,8.3,15.4,12.3,0.3,-7.1,12.6,4
37089,1032,1552,1399,1326,53,-520,1452,932,119230,0,8.7,13.1,11.8,0.4,-4.4,12.2,2
37091,183,307,-101,1413,43,-124,-58,-181,19453,1,9.4,15.7,-5.2,2.2,-6.3,-3,8
37093,932,479,231,403,72,453,303,755,54446,-1,17.2,8.9,4.3,1.3,8.4,5.6,2
37095,38,54,-32,711,-1,-16,-33,-49,4607,0,8.2,11.7,-6.9,-0.2,-3.5,-7.1,9
37097,2016,1908,3342,1680,395,108,3737,3836,199710,-9,10.2,9.6,16.9,2,0.5,18.9,1
37099,346,428,667,4606,69,-82,736,652,44574,-2,7.8,9.7,15.1,1.6,-1.9,16.6,7
37101,2831,1923,5726,2080,419,908,6145,7053,241955,0,11.9,8.1,24,1.8,3.8,25.8,1
37103,96,164,246,72,7,-68,253,182,9401,-3,10.3,17.6,26.4,0.8,-7.3,27.2,8
37105,783,751,1250,1018,226,32,1476,1516,67059,8,11.8,11.3,18.9,3.4,0.5,22.3,4
37107,657,897,603,1264,32,-240,635,396,54895,1,12,16.4,11,0.6,-4.4,11.6,4
37109,932,989,2518,806,110,-57,2628,2567,95675,-4,9.9,10.5,26.7,1.2,-0.6,27.8,1
37111,392,653,346,1329,52,-261,398,138,44893,1,8.7,14.6,7.7,1.2,-5.8,8.9,6
37113,323,606,693,255,32,-283,725,443,38412,1,8.5,15.9,18.1,0.8,-7.4,19,7
37115,189,295,278,1055,17,-106,295,190,22071,1,8.6,13.4,12.7,0.8,-4.8,13.4,2
37117,218,397,146,162,1,-179,147,-31,21447,1,10.2,18.5,6.8,0,-8.3,6.8,6
37119,15062,7093,2805,17200,8796,7969,11601,19626,1163701,56,13.1,6.1,2.4,7.6,6.9,10.1,1
37121,115,269,94,103,12,-154,106,-49,14999,-1,7.7,17.9,6.3,0.8,-10.3,7.1,8
37123,253,381,328,700,44,-128,372,244,26085,0,9.7,14.7,12.6,1.7,-4.9,14.3,8
37125,1192,1345,1452,952,107,-153,1559,1407,106898,1,11.2,12.7,13.7,1,-1.4,14.7,3
37127,1076,1174,755,1519,73,-98,828,731,96551,1,11.2,12.2,7.8,0.8,-1,8.6,3
37129,2215,2266,2748,6837,347,-51,3095,3068,238852,24,9.3,9.5,11.6,1.5,-0.2,13,2
37131,161,319,44,314,4,-158,48,-112,16715,-2,9.6,19,2.6,0.2,-9.4,2.9,9
37133,3888,1563,1988,24256,315,2325,2303,4645,213676,17,18.4,7.4,9.4,1.5,11,10.9,3
37135,1195,922,-522,10581,613,273,91,373,150626,9,7.9,6.1,-3.5,4.1,1.8,0.6,2
37137,87,212,311,631,3,-125,314,189,12423,0,7.1,17.2,25.2,0.2,-10.1,25.5,9
37139,429,489,303,2598,31,-60,334,276,41444,2,10.4,11.8,7.3,0.8,-1.5,8.1,4
37141,672,732,2798,1263,87,-60,2885,2823,68521,-2,10,10.9,41.7,1.3,-0.9,43,2
37143,114,199,248,96,-7,-85,241,156,13377,0,8.6,15,18.6,-0.5,-6.4,18.1,8
37145,424,518,476,354,12,-94,488,394,39737,0,10.7,13.1,12,0.3,-2.4,12.3,2
37147,2059,1614,710,4958,345,445,1055,1509,175119,9,11.8,9.3,4.1,2,2.6,6.1,3
37149,136,332,248,428,-3,-196,245,48,20060,-1,6.8,16.6,12.4,-0.1,-9.8,12.2,8
37151,1550,1860,1453,1523,120,-310,1573,1262,147458,-1,10.6,12.7,9.9,0.8,-2.1,10.7,2
37153,526,685,-90,954,-2,-159,-92,-249,42324,2,12.4,16.1,-2.1,0,-3.7,-2.2,4
37155,1862,1702,573,3548,162,160,735,899,117365,4,15.9,14.6,4.9,1.4,1.4,6.3,4
37157,919,1387,995,920,25,-468,1020,552,92518,0,10,15,10.8,0.3,-5.1,11.1,2
37159,1626,1941,2106,3956,200,-315,2306,1988,151661,-3,10.8,12.9,14,1.3,-2.1,15.3,1
37161,630,1016,925,1203,24,-386,949,562,65507,-1,9.7,15.6,14.2,0.4,-5.9,14.5,4
37163,813,826,447,1094,141,-13,588,574,59601,-1,13.7,13.9,7.5,2.4,-0.2,9.9,6
37165,412,515,64,3470,63,-103,127,26,34376,2,12,15,1.9,1.8,-3,3.7,6
37167,704,844,1551,1679,59,-140,1610,1468,65699,-2,10.8,13,23.9,0.9,-2.2,24.8,6
37169,421,675,656,624,-5,-254,651,396,45532,-1,9.3,14.9,14.5,-0.1,-5.6,14.4,2
37171,737,1053,254,955,40,-316,294,-20,71462,2,10.3,14.7,3.6,0.6,-4.4,4.1,6
37173,166,254,42,369,25,-88,67,-20,13916,1,11.9,18.2,3,1.8,-6.3,4.8,9
37175,245,483,363,863,48,-238,411,176,33549,3,7.3,14.4,10.8,1.4,-7.1,12.3,6
37177,40,49,-7,213,3,-9,-4,-12,3461,1,11.5,14.1,-2,0.9,-2.6,-1.2,9
37179,2512,1806,6010,2955,613,706,6623,7280,256452,-49,9.9,7.1,23.8,2.4,2.8,26.2,1
37181,522,631,116,449,140,-109,256,147,42301,0,12.4,14.9,2.7,3.3,-2.6,6.1,6
37183,13218,6484,7401,16504,5326,6734,12727,19497,1190275,36,11.2,5.5,6.3,4.5,5.7,10.8,1
37185,175,303,272,854,17,-128,289,159,18836,-2,9.3,16.2,14.5,0.9,-6.8,15.4,8
37187,111,194,13,155,6,-83,19,-63,10713,1,10.3,18.1,1.2,0.6,-7.7,1.8,9
37189,306,446,-161,7586,34,-140,-127,-265,54748,2,5.6,8.1,-2.9,0.6,-2.6,-2.3,5
37191,1593,1352,707,3790,291,241,998,1237,118686,-2,13.5,11.5,6,2.5,2,8.5,3
37193,681,973,467,1044,49,-292,516,222,66013,-2,10.3,14.8,7.1,0.7,-4.4,7.8,6
37195,887,1074,789,881,61,-187,850,664,78970,1,11.3,13.7,10,0.8,-2.4,10.8,4
37197,381,527,371,438,44,-146,415,267,37774,-2,10.1,14,9.9,1.2,-3.9,11,2
37199,174,299,268,122,26,-125,294,170,18938,1,9.2,15.9,14.2,1.4,-6.6,15.6,8
38000,9649,6945,-9,28831,2298,2704,2289,5014,783926,21,12.3,8.9,0,2.9,3.5,2.9,
38001,20,28,38,63,0,-8,38,30,2163,0,9.3,13,17.7,0,-3.7,17.7,9
38003,85,144,-19,518,45,-59,26,-35,10726,-2,7.9,13.4,-1.8,4.2,-5.5,2.4,6
38005,104,89,-50,48,7,15,-43,-27,5745,1,18.1,15.5,-8.7,1.2,2.6,-7.5,9
38007,14,7,1,8,0,7,1,9,1034,1,13.6,6.8,1,0,6.8,1,9
38009,74,69,-49,189,8,5,-41,-35,6349,1,11.6,10.8,-7.7,1.3,0.8,-6.4,8
38011,30,35,-28,45,1,-5,-27,-32,2867,0,10.4,12.1,-9.7,0.3,-1.7,-9.4,9
38013,22,21,1,0,0,1,1,2,2134,0,10.3,9.8,0.5,0,0.5,0.5,8
38015,1144,820,-27,3967,318,324,291,616,100012,1,11.5,8.2,-0.3,3.2,3.2,2.9,3
38017,2408,1273,1394,8412,1103,1135,2497,3649,196362,17,12.4,6.5,7.2,5.7,5.8,12.8,3
38019,36,47,-1,52,1,-11,0,-12,3596,-1,10,13,-0.3,0.3,-3.1,0,9
38021,58,71,-30,352,14,-13,-16,-28,4900,1,11.8,14.4,-6.1,2.8,-2.6,-3.3,9
38023,19,30,-23,41,0,-11,-23,-34,2135,0,8.8,13.9,-10.7,0,-5.1,-10.7,9
38025,69,41,-25,80,22,28,-3,25,4019,0,17.2,10.2,-6.2,5.5,7,-0.7,9
38027,31,47,-30,64,0,-16,-30,-44,2263,2,13.6,20.6,-13.1,0,-7,-13.1,9
38029,36,48,-19,47,0,-12,-19,-30,3224,1,11.1,14.8,-5.9,0,-3.7,-5.9,8
38031,37,43,-65,66,0,-6,-65,-71,3309,0,11.1,12.9,-19.4,0,-1.8,-19.4,9
38033,18,19,-3,70,0,-1,-3,-3,1743,1,10.3,10.9,-1.7,0,-0.6,-1.7,9
38035,853,546,-327,4299,303,307,-24,287,72708,4,11.8,7.5,-4.5,4.2,4.2,-0.3,3
38037,21,43,-11,62,10,-22,-1,-23,2215,0,9.4,19.3,-4.9,4.5,-9.9,-0.4,8
38039,23,29,5,85,0,-6,5,-1,2248,0,10.2,12.9,2.2,0,-2.7,2.2,9
38041,24,27,7,121,0,-3,7,4,2415,0,9.9,11.2,2.9,0,-1.2,2.9,9
38043,20,28,-30,0,0,-8,-30,-39,2342,-1,8.5,11.9,-12.7,0,-3.4,-12.7,8
38045,51,44,13,247,0,7,13,20,4096,0,12.5,10.8,3.2,0,1.7,3.2,9
38047,30,26,29,55,-1,4,28,31,1869,-1,16.2,14,15.6,-0.5,2.2,15.1,9
38049,62,72,-58,38,2,-10,-56,-64,5131,2,12,13.9,-11.2,0.4,-1.9,-10.8,3
38051,30,48,6,93,5,-18,11,-7,2488,0,12,19.3,2.4,2,-7.2,4.4,9
38053,219,90,216,94,17,129,233,363,14252,1,15.6,6.4,15.4,1.2,9.2,16.6,7
38055,93,109,-16,196,5,-16,-11,-26,9832,1,9.4,11.1,-1.6,0.5,-1.6,-1.1,8
38057,78,97,-19,112,20,-19,1,-18,8309,0,9.4,11.7,-2.3,2.4,-2.3,0.1,8
38059,418,345,108,728,10,73,118,190,33895,-1,12.4,10.2,3.2,0.3,2.2,3.5,3
38061,151,95,76,66,11,56,87,142,9383,-1,16.2,10.2,8.2,1.2,6,9.3,8
38063,25,45,0,112,11,-20,11,-8,2991,1,8.3,15,0,3.7,-6.7,3.7,8
38065,18,9,7,3,0,9,7,17,1879,1,9.6,4.8,3.7,0,4.8,3.7,3
38067,61,88,-66,120,11,-27,-55,-84,6661,-2,9.1,13.1,-9.8,1.6,-4,-8.2,9
38069,28,62,1,128,5,-34,6,-29,3902,-1,7.1,15.8,0.3,1.3,-8.7,1.5,9
38071,134,143,-52,432,9,-9,-43,-53,11463,-1,11.7,12.4,-4.5,0.8,-0.8,-3.7,7
38073,51,72,-31,378,8,-21,-23,-44,5603,0,9.1,12.8,-5.5,1.4,-3.7,-4.1,8
38075,28,30,8,35,23,-2,31,29,2279,0,12.4,13.2,3.5,10.2,-0.9,13.7,3
38077,169,138,-40,1028,-7,31,-47,-16,16558,0,10.2,8.3,-2.4,-0.4,1.9,-2.8,6
38079,166,189,-122,155,7,-23,-115,-139,11728,-1,14.1,16,-10.3,0.6,-1.9,-9.7,9
38081,42,47,-22,39,1,-5,-21,-28,3776,-2,11.1,12.4,-5.8,0.3,-1.3,-5.5,9
38083,8,19,-9,13,0,-11,-9,-20,1266,0,6.3,14.9,-7.1,0,-8.6,-7.1,8
38085,55,61,-40,65,0,-6,-40,-43,3643,3,15,16.6,-10.9,0,-1.6,-10.9,9
38087,6,4,-11,0,0,2,-11,-8,674,1,8.8,5.9,-16.2,0,2.9,-16.2,9
38089,484,273,30,675,41,211,71,283,33001,1,14.7,8.3,0.9,1.2,6.4,2.2,5
38091,18,19,-9,0,0,-1,-9,-11,1782,-1,10.1,10.6,-5,0,-0.6,-5,8
38093,204,235,-83,1877,30,-31,-53,-84,21392,0,9.5,11,-3.9,1.4,-1.4,-2.5,7
38095,22,26,-33,25,8,-4,-25,-30,2030,-1,10.8,12.7,-16.1,3.9,-2,-12.2,9
38097,77,92,-40,372,8,-15,-32,-47,7908,0,9.7,11.6,-5,1,-1.9,-4,8
38099,125,126,-165,275,11,-1,-154,-155,10305,0,12,12.1,-15.9,1.1,-0.1,-14.8,8
38101,1001,531,-1072,2282,150,470,-922,-456,68332,-4,14.6,7.7,-15.6,2.2,6.9,-13.4,3
38103,29,60,-14,83,0,-31,-14,-46,3876,-1,7.4,15.4,-3.6,0,-8,-3.6,9
38105,620,245,690,516,81,375,771,1147,39113,1,16.1,6.4,17.9,2.1,9.7,20,5
39000,128826,131288,637,296114,28081,-2462,28718,26238,11785935,-18,10.9,11.2,0.1,2.4,-0.2,2.4,
39001,327,427,131,282,32,-100,163,62,27521,-1,11.9,15.5,4.8,1.2,-3.6,5.9,8
39003,1209,1236,-302,3553,66,-27,-236,-259,100838,4,12,12.2,-3,0.7,-0.3,-2.3,3
39005,571,691,269,1171,20,-120,289,166,52190,-3,11,13.3,5.2,0.4,-2.3,5.5,6
39007,1010,1328,187,3514,18,-318,205,-115,96845,-2,10.4,13.7,1.9,0.2,-3.3,2.1,1
39009,456,607,1645,8762,315,-151,1960,1825,62706,16,7.4,9.8,26.6,5.1,-2.4,31.7,4
39011,522,548,127,466,6,-26,133,104,46050,-3,11.3,11.9,2.8,0.1,-0.6,2.9,4
39013,483,940,-118,3801,-3,-457,-121,-577,64918,1,7.4,14.4,-1.8,0,-7,-1.9,3
39015,482,600,195,509,3,-118,198,77,43777,-3,11,13.7,4.5,0.1,-2.7,4.5,1
39017,4310,3737,1090,12048,1631,573,2721,3315,393043,21,11,9.5,2.8,4.2,1.5,7,1
39019,229,385,233,329,1,-156,234,72,26758,-6,8.6,14.4,8.7,0,-5.8,8.8,2
39021,432,476,139,439,6,-44,145,102,38845,1,11.1,12.3,3.6,0.2,-1.1,3.7,6
39023,1535,1933,133,2529,143,-398,276,-122,134610,0,11.4,14.4,1,1.1,-3,2,3
39025,2190,2154,998,2109,251,36,1249,1293,211972,8,10.4,10.2,4.7,1.2,0.2,5.9,1
39027,484,556,35,1194,85,-72,120,48,41938,0,11.5,13.3,0.8,2,-1.7,2.9,6
39029,958,1415,78,3729,-7,-457,71,-387,100182,-1,9.5,14.1,0.8,-0.1,-4.6,0.7,4
39031,424,476,295,348,12,-52,307,254,36869,-1,11.5,13,8,0.3,-1.4,8.4,7
39033,442,630,161,449,46,-188,207,20,41529,1,10.6,15.2,3.9,1.1,-4.5,5,4
39035,13037,13916,-6999,26720,3965,-879,-3034,-3906,1233088,7,10.6,11.3,-5.7,3.2,-0.7,-2.5,1
39037,586,664,-46,624,11,-78,-35,-111,51415,2,11.4,12.9,-0.9,0.2,-1.5,-0.7,6
39039,407,457,149,696,88,-50,237,187,38315,0,10.6,12,3.9,2.3,-1.3,6.2,6
39041,2162,1420,3666,1980,736,742,4402,5110,231636,-34,9.4,6.2,16,3.2,3.2,19.2,1
39043,656,993,-193,2000,49,-337,-144,-479,74035,2,8.8,13.4,-2.6,0.7,-4.5,-1.9,3
39045,1727,1605,2014,3296,286,122,2300,2404,165360,-18,10.5,9.8,12.3,1.7,0.7,14,1
39047,337,416,40,360,24,-79,64,-15,28817,0,11.7,14.4,1.4,0.8,-2.7,2.2,6
39049,17429,10554,-11882,29758,9355,6875,-2527,4333,1326063,-15,13.2,8,-9,7.1,5.2,-1.9,1
39051,440,509,-125,354,41,-69,-84,-151,42007,2,10.5,12.1,-3,1,-1.6,-2,2
39053,319,430,62,577,5,-111,67,-44,28986,0,11,14.8,2.1,0.2,-3.8,2.3,6
39055,914,962,-101,1199,69,-48,-32,-84,95407,-4,9.6,10.1,-1.1,0.7,-0.5,-0.3,1
39057,1649,1652,278,7459,389,-3,667,664,169691,0,9.7,9.8,1.6,2.3,0,3.9,2
39059,410,595,215,503,3,-185,218,29,38089,-4,10.8,15.6,5.6,0.1,-4.9,5.7,6
39061,10244,8060,-3058,24281,3200,2184,142,2337,827058,11,12.4,9.8,-3.7,3.9,2.6,0.2,1
39063,840,851,-226,2007,164,-11,-62,-70,74704,3,11.2,11.4,-3,2.2,-0.1,-0.8,4
39065,365,428,11,1824,29,-63,40,-23,30368,0,12,14.1,0.4,1,-2.1,1.3,6
39067,135,250,-78,220,1,-115,-77,-192,14159,0,9.5,17.5,-5.5,0.1,-8.1,-5.4,8
39069,306,348,32,320,4,-42,36,-6,27520,0,11.1,12.6,1.2,0.1,-1.5,1.3,6
39071,556,600,222,402,10,-44,232,188,43614,0,12.8,13.8,5.1,0.2,-1,5.3,6
39073,276,402,-153,192,0,-126,-153,-278,27540,1,10,14.5,-5.5,0,-4.6,-5.5,1
39075,779,366,-413,732,7,413,-406,11,44386,4,17.6,8.2,-9.3,0.2,9.3,-9.1,9
39077,650,710,-2,445,41,-60,39,-20,58199,1,11.2,12.2,0,0.7,-1,0.7,4
39079,377,471,69,299,20,-94,89,-5,32606,0,11.6,14.4,2.1,0.6,-2.9,2.7,7
39081,533,1042,244,2710,20,-509,264,-247,64026,-2,8.3,16.2,3.8,0.3,-7.9,4.1,3
39083,756,717,48,3547,38,39,86,124,63320,-1,12,11.3,0.8,0.6,0.6,1.4,6
39085,2074,2758,277,2461,314,-684,591,-96,231640,-3,9,11.9,1.2,1.4,-3,2.6,1
39087,524,962,-14,544,-1,-438,-15,-454,56118,-1,9.3,17.1,-0.2,0,-7.8,-0.3,2
39089,1902,1900,1256,4137,177,2,1433,1436,183201,1,10.4,10.4,6.9,1,0,7.9,1
39091,524,537,-9,391,19,-13,10,-5,46057,-2,11.4,11.7,-0.2,0.4,-0.3,0.2,4
39093,3200,3558,1927,8173,321,-358,2248,1879,317910,-11,10.1,11.2,6.1,1,-1.1,7.1,1
39095,4957,4811,-1964,9849,563,146,-1401,-1235,425484,20,11.6,11.3,-4.6,1.3,0.3,-3.3,2
39097,449,474,986,4872,52,-25,1038,1021,44602,8,10.2,10.8,22.4,1.2,-0.6,23.5,1
39099,2379,3197,213,7134,284,-818,497,-326,225596,-5,10.5,14.2,0.9,1.3,-3.6,2.2,2
39101,723,845,351,5474,8,-122,359,242,64851,5,11.2,13.1,5.4,0.1,-1.9,5.5,4
39103,1667,1761,543,1713,117,-94,660,553,184042,-13,9.1,9.6,3,0.6,-0.5,3.6,1
39105,207,374,-45,178,17,-167,-28,-194,21767,1,9.5,17.1,-2.1,0.8,-7.6,-1.3,8
39107,650,437,-224,533,24,213,-200,15,42439,2,15.3,10.3,-5.3,0.6,5,-4.7,7
39109,1147,1280,651,960,150,-133,801,663,110876,-5,10.4,11.6,5.9,1.4,-1.2,7.2,2
39111,121,220,30,78,9,-99,39,-62,13153,-2,9.2,16.7,2.3,0.7,-7.5,3,8
39113,6115,6581,-505,13382,1282,-466,777,322,533796,11,11.5,12.3,-0.9,2.4,-0.9,1.5,2
39115,137,231,71,129,0,-94,71,-23,13646,0,10,16.9,5.2,0,-6.9,5.2,8
39117,373,392,280,290,0,-19,280,259,35595,-2,10.5,11.1,7.9,0,-0.5,7.9,1
39119,985,1045,245,1551,7,-60,252,191,86305,-1,11.4,12.1,2.8,0.1,-0.7,2.9,4
39121,147,149,-14,2746,2,-2,-12,-14,14311,0,10.3,10.4,-1,0.1,-0.1,-0.8,9
39123,280,573,114,473,14,-293,128,-165,39803,0,7,14.4,2.9,0.4,-7.3,3.2,3
39125,220,224,-57,88,3,-4,-54,-56,18706,2,11.7,12,-3,0.2,-0.2,-2.9,8
39127,379,430,131,316,2,-51,133,80,35551,-2,10.7,12.1,3.7,0.1,-1.4,3.7,1
39129,625,701,1142,4176,13,-76,1155,1079,61086,0,10.3,11.6,18.9,0.2,-1.3,19.1,1
39131,315,436,112,365,-1,-121,111,-11,27001,-1,11.7,16.1,4.1,0,-4.5,4.1,9
39133,1363,1720,966,7133,315,-357,1281,923,162665,-1,8.4,10.6,6,1.9,-2.2,7.9,2
39135,401,534,112,338,7,-133,119,-18,40556,-4,9.9,13.2,2.8,0.2,-3.3,2.9,6
39137,416,370,-196,398,16,46,-180,-131,34199,3,12.1,10.8,-5.7,0.5,1.3,-5.3,6
39139,1354,1638,21,7312,65,-284,86,-197,125064,1,10.8,13.1,0.2,0.5,-2.3,0.7,3
39141,776,1068,279,5170,3,-292,282,-7,76501,3,10.1,14,3.6,0,-3.8,3.7,4
39143,577,762,245,853,83,-185,328,142,58709,-1,9.8,13,4.2,1.4,-3.2,5.6,4
39145,731,1152,187,3182,14,-421,201,-220,71969,0,10.1,16,2.6,0.2,-5.8,2.8,4
39147,592,669,13,2288,57,-77,70,-7,54527,0,10.9,12.3,0.2,1,-1.4,1.3,4
39149,619,546,-25,480,33,73,8,81,47765,0,13,11.4,-0.5,0.7,1.5,0.2,4
39151,3934,4637,403,7401,235,-703,638,-69,372716,-4,10.6,12.4,1.1,0.6,-1.9,1.7,2
39153,5430,6346,-300,8742,1166,-916,866,-36,535733,14,10.1,11.8,-0.6,2.2,-1.7,1.6,2
39155,1974,2854,486,3760,45,-880,531,-353,200373,-4,9.8,14.2,2.4,0.2,-4.4,2.6,2
39157,1131,1206,-93,1051,69,-75,-24,-97,91874,2,12.3,13.1,-1,0.8,-0.8,-0.3,4
39159,723,497,2437,2883,100,226,2537,2761,69637,-2,10.6,7.3,35.7,1.5,3.3,37.2,1
39161,339,361,-105,369,26,-22,-79,-100,28704,1,11.8,12.6,-3.7,0.9,-0.8,-2.7,6
39163,149,220,-32,56,0,-71,-32,-103,12474,0,11.9,17.6,-2.6,0,-5.7,-2.6,8
39165,2462,2078,1243,4339,814,384,2057,2413,252148,-28,9.8,8.3,5,3.2,1.5,8.2,1
39167,524,849,-6,1328,42,-325,36,-291,58577,-2,8.9,14.5,-0.1,0.7,-5.5,0.6,4
39169,1410,1346,-265,3991,152,64,-113,-42,116510,7,12.1,11.6,-2.3,1.3,0.5,-1,4
39171,404,471,-27,998,36,-67,9,-57,36591,1,11,12.9,-0.7,1,-1.8,0.2,7
39173,1254,1232,739,6022,241,22,980,1008,132650,6,9.5,9.3,5.6,1.8,0.2,7.4,2
39175,209,299,-12,270,6,-90,-6,-95,21457,1,9.7,13.9,-0.6,0.3,-4.2,-0.3,7
4000,78494,70792,36179,162728,21635,7702,57814,65660,7431344,144,10.6,9.6,4.9,2.9,1,7.8,
40000,48073,45506,23587,117382,8380,2567,31967,34553,4053824,19,11.9,11.3,5.8,2.1,0.6,7.9,
40001,313,319,111,193,6,-6,117,111,19627,0,16,16.3,5.7,0.3,-0.3,6,8
40003,41,47,-27,1162,18,-6,-9,-16,5673,-1,7.2,8.3,-4.8,3.2,-1.1,-1.6,8
40005,133,177,219,1581,23,-44,242,198,14525,0,9.2,12.3,15.2,1.6,-3.1,16.8,9
40007,64,57,-41,52,33,7,-8,-1,5018,0,12.8,11.4,-8.2,6.6,1.4,-1.6,9
40009,221,285,133,2399,-4,-64,129,66,22042,1,10,12.9,6,-0.2,-2.9,5.9,7
4001,724,975,-302,1203,56,-251,-246,-497,65036,0,11.1,14.9,-4.6,0.9,-3.8,-3.8,8
40011,120,147,61,88,60,-27,121,94,8539,0,14.1,17.3,7.2,7.1,-3.2,14.2,8
40013,526,644,1008,907,42,-118,1050,929,48967,-3,10.8,13.3,20.8,0.9,-2.4,21.6,6
40015,307,419,6,3624,83,-112,89,-23,26214,0,11.7,16,0.2,3.2,-4.3,3.4,6
40017,1977,1185,5634,2298,158,792,5792,6575,175829,-9,11.5,6.9,32.7,0.9,4.6,33.6,1
40019,608,747,316,599,79,-139,395,260,48596,4,12.5,15.4,6.5,1.6,-2.9,8.2,5
40021,514,588,145,1882,38,-74,183,111,48185,2,10.7,12.2,3,0.8,-1.5,3.8,6
40023,177,290,-21,137,4,-113,-17,-131,14276,-1,12.3,20.2,-1.5,0.3,-7.9,-1.2,9
40025,23,31,-34,4,0,-8,-34,-42,2191,0,10.4,14,-15.4,0,-3.6,-15.4,9
40027,2688,2227,588,13178,662,461,1250,1709,301193,-2,8.9,7.4,2,2.2,1.5,4.2,1
40029,65,94,2,47,2,-29,4,-25,5266,0,12.3,17.8,0.4,0.4,-5.5,0.8,9
4003,1246,1612,-695,3421,228,-366,-467,-847,124640,-14,10,12.9,-5.6,1.8,-2.9,-3.7,3
40031,1553,1286,-1057,9310,142,267,-915,-651,121574,-3,12.7,10.5,-8.7,1.2,2.2,-7.5,3
40033,57,104,27,36,0,-47,27,-22,5427,-2,10.5,19.1,5,0,-8.6,5,3
40035,159,216,338,985,41,-57,379,318,14494,-4,11.1,15.1,23.6,2.9,-4,26.4,6
40037,774,945,803,731,20,-171,823,646,73332,-6,10.6,12.9,11,0.3,-2.3,11.3,1
40039,357,328,183,1381,18,29,201,227,28266,-3,12.7,11.7,6.5,0.6,1,7.1,5
40041,436,705,476,549,12,-269,488,223,41703,4,10.5,17,11.4,0.3,-6.5,11.7,6
40043,63,80,-102,58,1,-17,-101,-118,4286,0,14.5,18.4,-23.5,0.2,-3.9,-23.2,9
40045,40,50,-34,45,9,-10,-25,-35,3648,0,10.9,13.6,-9.3,2.5,-2.7,-6.8,9
40047,819,781,-89,1611,121,38,32,72,62023,2,13.2,12.6,-1.4,2,0.6,0.5,3
40049,325,426,172,154,23,-101,195,94,25865,0,12.6,16.5,6.7,0.9,-3.9,7.6,6
4005,1315,1059,-296,11776,292,256,-4,249,144472,-3,9.1,7.3,-2.1,2,1.8,0,3
40051,572,650,776,1641,33,-78,809,727,57375,-4,10,11.4,13.6,0.6,-1.4,14.2,1
40053,45,70,-14,78,1,-25,-13,-39,4083,-1,11,17.1,-3.4,0.2,-6.1,-3.2,8
40055,53,93,-42,870,2,-40,-40,-80,5466,0,9.6,16.9,-7.6,0.4,-7.3,-7.3,9
40057,27,47,-4,53,0,-20,-4,-24,2392,0,11.2,19.6,-1.7,0,-8.3,-1.7,9
40059,27,38,12,43,24,-11,36,25,3190,0,8.5,12,3.8,7.6,-3.5,11.3,9
40061,152,189,192,60,9,-37,201,165,11832,1,12.9,16.1,16.3,0.8,-3.1,17.1,8
40063,158,222,66,1791,-1,-64,65,2,13436,1,11.8,16.5,4.9,-0.1,-4.8,4.8,9
40065,358,276,-121,726,52,82,-69,10,24669,-3,14.5,11.2,-4.9,2.1,3.3,-2.8,7
40067,57,93,-29,55,3,-36,-26,-61,5347,1,10.6,17.3,-5.4,0.6,-6.7,-4.8,8
40069,117,175,-74,385,4,-58,-70,-130,10216,-2,11.4,17,-7.2,0.4,-5.6,-6.8,9
4007,453,931,562,829,-6,-478,556,81,54003,3,8.4,17.3,10.4,-0.1,-8.9,10.3,4
40071,553,631,-28,1102,9,-78,-19,-97,43641,0,12.7,14.4,-0.6,0.2,-1.8,-0.4,4
40073,153,166,193,266,74,-13,267,253,15481,-1,10,10.8,12.6,4.8,-0.8,17.4,8
40075,107,141,-50,132,4,-34,-46,-82,8398,-2,12.7,16.7,-5.9,0.5,-4,-5.5,8
40077,101,162,31,302,2,-61,33,-30,9526,-2,10.6,17,3.2,0.2,-6.4,3.5,9
40079,769,736,525,1666,35,33,560,594,49596,1,15.6,14.9,10.6,0.7,0.7,11.4,6
40081,325,452,555,224,7,-127,562,428,34562,-7,9.5,13.2,16.2,0.2,-3.7,16.4,1
40083,541,467,950,1952,83,74,1033,1105,53029,-2,10.3,8.9,18.1,1.6,1.4,19.7,1
40085,101,140,151,77,10,-39,161,122,10296,0,9.9,13.7,14.8,1,-3.8,15.7,9
40087,455,403,1599,316,16,52,1615,1662,47072,-5,9.8,8.7,34.6,0.3,1.1,34.9,1
40089,356,554,45,291,41,-198,86,-113,30660,-1,11.6,18,1.5,1.3,-6.4,2.8,7
4009,493,408,614,2455,-2,85,612,703,39525,6,12.6,10.4,15.7,-0.1,2.2,15.6,7
40091,189,393,404,321,1,-204,405,200,19603,-1,9.7,20.2,20.7,0.1,-10.5,20.8,8
40093,86,115,66,97,7,-29,73,45,7581,1,11.4,15.2,8.7,0.9,-3.8,9.7,8
40095,214,257,38,177,52,-43,90,49,15970,2,13.4,16.1,2.4,3.3,-2.7,5.6,9
40097,478,607,445,420,4,-129,449,319,39889,-1,12,15.3,11.2,0.1,-3.2,11.3,6
40099,153,216,138,413,-1,-63,137,73,13754,-1,11.2,15.7,10.1,-0.1,-4.6,10,9
40101,845,1045,527,3636,39,-200,566,370,66677,4,12.7,15.7,7.9,0.6,-3,8.5,4
40103,88,171,56,357,15,-83,71,-13,10832,-1,8.1,15.8,5.2,1.4,-7.7,6.6,8
40105,107,151,60,108,8,-44,68,25,9438,1,11.4,16,6.4,0.8,-4.7,7.2,8
40107,140,179,100,1235,12,-39,112,73,11300,0,12.4,15.9,8.9,1.1,-3.5,9.9,8
40109,10906,7664,-56,16000,2539,3242,2483,5763,808866,38,13.5,9.5,-0.1,3.2,4,3.1,1
4011,118,98,-9,1,31,20,22,42,9369,0,12.6,10.5,-1,3.3,2.1,2.4,9
40111,432,636,225,1315,3,-204,228,24,37035,0,11.7,17.2,6.1,0.1,-5.5,6.2,1
40113,420,569,429,1400,-1,-149,428,278,46130,-1,9.1,12.4,9.3,0,-3.2,9.3,1
40115,432,533,31,994,27,-101,58,-42,30287,1,14.3,17.6,1,0.9,-3.3,1.9,6
40117,162,256,279,174,0,-94,279,183,15864,-2,10.3,16.2,17.7,0,-6,17.7,1
40119,750,692,130,9463,463,58,593,651,83352,0,9,8.3,1.6,5.6,0.7,7.1,4
4012,165,376,312,176,78,-211,390,175,16710,-4,9.9,22.6,18.8,4.7,-12.7,23.5,6
40121,487,699,204,2055,12,-212,216,3,43479,-1,11.2,16.1,4.7,0.3,-4.9,5,7
40123,458,549,446,727,11,-91,457,364,38396,-2,12,14.4,11.7,0.3,-2.4,12,7
40125,841,1033,608,3436,18,-192,626,440,73791,6,11.4,14,8.3,0.2,-2.6,8.5,4
40127,100,249,235,116,6,-149,241,91,10800,-1,9.3,23.2,21.9,0.6,-13.9,22.4,9
40129,35,43,-41,6,7,-8,-34,-42,3295,0,10.6,13,-12.4,2.1,-2.4,-10.3,9
4013,50795,38287,2179,77694,15217,12508,17396,30038,4585871,134,11.1,8.4,0.5,3.3,2.7,3.8,1
40131,1055,988,1073,1787,57,67,1130,1188,100248,-9,10.6,9.9,10.8,0.6,0.7,11.3,1
40133,286,398,201,604,12,-112,213,101,23565,0,12.2,16.9,8.5,0.5,-4.8,9.1,7
40135,600,594,481,411,2,6,483,490,40291,1,15,14.8,12,0,0.1,12.1,3
40137,480,640,520,603,40,-160,560,398,44014,-2,11,14.6,11.9,0.9,-3.7,12.8,4
40139,339,152,-512,368,191,187,-321,-134,20371,0,16.6,7.4,-25.1,9.3,9.1,-15.7,7
40141,63,125,-39,118,0,-62,-39,-102,6869,-1,9.1,18.1,-5.6,0,-9,-5.6,8
40143,8632,6662,1152,11953,2642,1970,3794,5807,682868,43,12.7,9.8,1.7,3.9,2.9,5.6,1
40145,914,816,2391,284,100,98,2491,2583,89280,-6,10.4,9.3,27.2,1.1,1.1,28.3,1
40147,579,702,508,1160,89,-123,597,468,53706,-6,10.8,13.1,9.5,1.7,-2.3,11.2,4
40149,117,155,29,226,7,-38,36,0,10736,2,10.9,14.4,2.7,0.7,-3.5,3.4,9
4015,1736,3993,4952,4527,81,-2257,5033,2777,223682,1,7.8,18,22.3,0.4,-10.2,22.6,3
40151,87,93,-36,1017,3,-6,-33,-38,8564,1,10.1,10.8,-4.2,0.3,-0.7,-3.8,7
40153,211,241,-55,1360,16,-30,-39,-68,19947,1,10.6,12.1,-2.8,0.8,-1.5,-2,7
4017,1228,1597,707,1550,38,-369,745,375,109175,-1,11.3,14.7,6.5,0.3,-3.4,6.8,4
4019,10006,11276,3823,26988,3105,-1270,6928,5686,1063162,28,9.4,10.6,3.6,2.9,-1.2,6.5,1
4021,5015,4293,17463,20632,1033,722,18496,19202,484239,-16,10.6,9,36.8,2.2,1.5,39,1
4023,554,382,-27,115,332,172,305,478,49158,1,11.3,7.8,-0.6,6.8,3.5,6.2,6
4025,1777,3587,4514,3989,153,-1810,4667,2851,249081,-6,7.2,14.5,18.2,0.6,-7.3,18.8,3
4027,2869,1918,2382,7372,999,951,3381,4347,213221,15,13.6,9.1,11.3,4.7,4.5,16,3
41000,39046,43285,-6051,97030,4304,-4239,-1747,-6021,4233358,-35,9.2,10.2,-1.4,1,-1,-0.4,
41001,144,270,98,426,4,-126,102,-25,16912,-1,8.5,16,5.8,0.2,-7.4,6,7
41003,620,670,-223,6493,323,-50,100,52,97713,2,6.3,6.9,-2.3,3.3,-0.5,1,3
41005,3638,3881,76,3921,228,-243,304,55,423173,-6,8.6,9.2,0.2,0.5,-0.6,0.7,1
41007,304,540,-334,509,27,-236,-307,-550,41102,-7,7.3,13.1,-8.1,0.7,-5.7,-7.4,4
41009,442,563,401,502,-6,-121,395,273,53880,-1,8.2,10.5,7.5,-0.1,-2.3,7.3,1
41011,507,1117,-111,1315,22,-610,-89,-711,64212,-12,7.9,17.3,-1.7,0.3,-9.4,-1.4,5
41013,244,326,657,157,0,-82,657,575,26952,0,9.2,12.2,24.6,0,-3.1,24.6,3
41015,144,469,21,178,-10,-325,11,-317,23296,-3,6.1,20,0.9,-0.4,-13.9,0.5,7
41017,1848,1729,1841,1699,48,119,1889,2030,208513,22,8.9,8.3,8.9,0.2,0.6,9.1,3
41019,951,1889,1078,1661,4,-938,1082,145,112435,1,8.5,16.8,9.6,0,-8.3,9.6,4
41021,18,36,38,25,-1,-18,37,18,2026,-1,8.9,17.8,18.8,-0.5,-8.9,18.3,9
41023,69,115,30,68,5,-46,35,-10,7215,1,9.6,15.9,4.2,0.7,-6.4,4.8,9
41025,78,109,-59,135,-2,-31,-61,-92,7440,0,10.4,14.6,-7.9,-0.3,-4.1,-8.1,9
41027,221,194,-313,374,-2,27,-315,-290,23745,-2,9.3,8.1,-13.1,-0.1,1.1,-13.2,6
41029,2083,2758,-216,3273,-9,-675,-225,-901,220768,-1,9.4,12.5,-1,0,-3.1,-1,3
41031,262,293,162,1095,-3,-31,159,130,25454,2,10.3,11.5,6.4,-0.1,-1.2,6.3,3
41033,802,1446,644,1502,23,-644,667,21,87821,-2,9.1,16.5,7.3,0.3,-7.3,7.6,3
41035,740,1009,93,1034,-12,-269,81,-187,70003,1,10.6,14.4,1.3,-0.2,-3.8,1.2,5
41037,81,145,-29,543,13,-64,-16,-80,8293,0,9.7,17.4,-3.5,1.6,-7.7,-1.9,9
41039,3033,4439,154,13194,255,-1406,409,-1000,381181,-3,7.9,11.6,0.4,0.7,-3.7,1.1,2
41041,356,765,442,567,32,-409,474,69,50821,4,7,15.1,8.7,0.6,-8.1,9.3,5
41043,1391,1576,1045,1418,10,-185,1055,874,131496,4,10.6,12,8,0.1,-1.4,8,3
41045,365,376,188,3190,11,-11,199,186,32044,-2,11.4,11.8,5.9,0.3,-0.3,6.2,6
41047,3847,3380,-712,10681,265,467,-447,22,346741,2,11.1,9.7,-2.1,0.8,1.3,-1.3,2
41049,139,126,-21,28,18,13,-3,10,12302,0,11.3,10.2,-1.7,1.5,1.1,-0.2,8
41051,7271,6731,-6518,22225,1158,540,-5360,-4865,789698,-45,9.2,8.5,-8.2,1.5,0.7,-6.8,1
41053,864,885,192,2084,43,-21,235,212,89805,-2,9.6,9.9,2.1,0.5,-0.2,2.6,2
41055,22,25,7,0,1,-3,8,4,1951,-1,11.3,12.8,3.6,0.5,-1.5,4.1,9
41057,209,419,107,402,-3,-210,104,-104,27417,2,7.6,15.3,3.9,-0.1,-7.6,3.8,7
41059,789,842,-185,4569,27,-53,-158,-208,80053,3,9.8,10.5,-2.3,0.3,-0.7,-2,4
41061,255,351,-132,359,7,-96,-125,-221,25944,0,9.8,13.5,-5.1,0.3,-3.7,-4.8,7
41063,60,115,80,61,0,-55,80,24,7674,-1,7.8,15,10.4,0,-7.2,10.4,9
41065,248,388,-80,669,0,-140,-80,-222,26333,-2,9.4,14.7,-3,0,-5.3,-3,7
41067,5973,4131,-4782,7231,1709,1842,-3073,-1221,598865,10,10,6.9,-8,2.9,3.1,-5.1,1
41069,7,21,14,9,0,-14,14,1,1436,1,4.9,14.6,9.8,0,-9.8,9.8,9
41071,1021,1156,296,5433,119,-135,415,282,108644,2,9.4,10.7,2.7,1.1,-1.2,3.8,1
42000,129489,140568,-24825,433964,25776,-11079,951,-10408,12961683,-280,10,10.8,-1.9,2,-0.9,0.1,
42001,953,1142,909,4805,76,-189,985,789,106748,-7,9,10.7,8.5,0.7,-1.8,9.3,3
42003,11896,13684,-8665,39263,2674,-1788,-5991,-7780,1224825,-1,9.7,11.1,-7.1,2.2,-1.5,-4.9,1
42005,526,977,-192,676,12,-451,-180,-630,64074,1,8.2,15.2,-3,0.2,-7,-2.8,1
42007,1463,2202,568,2877,63,-739,631,-106,165631,2,8.8,13.3,3.4,0.4,-4.5,3.8,1
42009,463,675,126,313,19,-212,145,-71,47350,-4,9.8,14.2,2.7,0.4,-4.5,3.1,8
42011,4567,4304,-103,13644,1086,263,983,1248,432821,2,10.6,10,-0.2,2.5,0.6,2.3,2
42013,1123,1685,46,4127,54,-562,100,-461,120273,1,9.3,14,0.4,0.4,-4.7,0.8,3
42015,622,788,-34,636,41,-166,7,-159,59695,0,10.4,13.2,-0.6,0.7,-2.8,0.1,6
42017,5821,6193,-52,8899,875,-372,823,427,645984,-24,9,9.6,-0.1,1.4,-0.6,1.3,1
42019,1615,2207,1530,7191,120,-592,1650,1045,198413,-13,8.2,11.2,7.7,0.6,-3,8.3,1
42021,1125,1876,-46,6200,41,-751,-5,-761,130668,-5,8.6,14.3,-0.4,0.3,-5.7,0,3
42023,27,80,27,26,1,-53,28,-26,4380,-1,6.1,18.2,6.1,0.2,-12.1,6.4,9
42025,583,911,267,824,25,-328,292,-35,65458,1,8.9,13.9,4.1,0.4,-5,4.5,2
42027,1088,1133,-528,19670,828,-45,300,262,157795,7,6.9,7.2,-3.3,5.3,-0.3,1.9,3
42029,5675,3971,279,15031,1163,1704,1442,3146,549784,0,10.4,7.2,0.5,2.1,3.1,2.6,1
42031,344,576,-48,2187,22,-232,-26,-257,36970,1,9.3,15.5,-1.3,0.6,-6.3,-0.7,6
42033,675,1142,-298,3828,28,-467,-270,-734,77090,3,8.7,14.7,-3.8,0.4,-6,-3.5,4
42035,349,472,-56,1811,10,-123,-46,-169,37607,0,9.3,12.5,-1.5,0.3,-3.3,-1.2,6
42037,542,821,403,4044,28,-279,431,150,65439,-2,8.3,12.6,6.2,0.4,-4.3,6.6,4
42039,870,1141,-152,3203,18,-271,-134,-404,82001,1,10.6,13.9,-1.8,0.2,-3.3,-1.6,4
42041,2508,2504,1773,14200,451,4,2224,2206,270738,-22,9.3,9.3,6.6,1.7,0,8.2,2
42043,3081,2887,-482,6882,823,194,341,547,289234,12,10.7,10,-1.7,2.8,0.7,1.2,2
42045,6383,5362,-1788,23036,1585,1021,-203,847,576720,29,11.1,9.3,-3.1,2.8,1.8,-0.4,1
42047,259,445,-81,296,-2,-186,-83,-269,30198,0,8.5,14.7,-2.7,-0.1,-6.1,-2.7,7
42049,2738,3050,-1332,13506,366,-312,-966,-1269,267571,9,10.2,11.4,-5,1.4,-1.2,-3.6,2
42051,723,2112,-148,3746,84,-1389,-64,-1453,123915,0,5.8,16.9,-1.2,0.7,-11.1,-0.5,1
42053,23,117,-62,2448,2,-94,-60,-154,6449,0,3.5,17.9,-9.5,0.3,-14.4,-9.2,9
42055,1718,1855,818,1620,226,-137,1044,903,157854,-4,10.9,11.8,5.2,1.4,-0.9,6.6,3
42057,135,231,6,130,4,-96,10,-86,14468,0,9.3,15.9,0.4,0.3,-6.6,0.7,8
42059,158,507,181,2784,-4,-349,177,-172,34357,0,4.6,14.7,5.3,-0.1,-10.1,5.1,6
42061,417,567,355,4788,10,-150,365,217,43514,2,9.6,13.1,8.2,0.2,-3.5,8.4,6
42063,733,1038,256,6031,78,-305,334,30,83094,1,8.8,12.5,3.1,0.9,-3.7,4,4
42065,445,617,50,614,3,-172,53,-119,43612,0,10.2,14.1,1.1,0.1,-3.9,1.2,7
42067,263,342,12,268,29,-79,41,-38,23243,0,11.3,14.7,0.5,1.2,-3.4,1.8,8
42069,2093,2675,565,8470,403,-582,968,373,216123,-13,9.7,12.4,2.6,1.9,-2.7,4.5,2
42071,6887,5280,-556,15743,871,1607,315,1929,558589,7,12.4,9.5,-1,1.6,2.9,0.6,2
42073,766,1313,200,2043,7,-547,207,-340,84472,0,9,15.5,2.4,0.1,-6.5,2.4,1
42075,1578,1707,250,3350,226,-129,476,350,144252,3,11,11.8,1.7,1.6,-0.9,3.3,3
42077,3940,3605,-616,7725,1745,335,1129,1480,377754,16,10.5,9.6,-1.6,4.6,0.9,3,2
42079,3191,4124,914,11011,930,-933,1844,892,327388,-19,9.8,12.6,2.8,2.8,-2.9,5.6,2
42081,934,1436,89,5138,100,-502,189,-310,112724,3,8.3,12.7,0.8,0.9,-4.4,1.7,3
42083,324,592,-44,2861,12,-268,-32,-300,39519,0,8.2,14.9,-1.1,0.3,-6.8,-0.8,7
42085,1014,1654,7,5906,0,-640,7,-634,108503,-1,9.3,15.2,0.1,0,-5.9,0.1,4
42087,535,622,17,636,7,-87,24,-62,45922,1,11.6,13.5,0.4,0.2,-1.9,0.5,4
42089,1338,1702,-1165,2984,120,-364,-1045,-1398,166053,11,8,10.2,-7,0.7,-2.2,-6.3,4
42091,8700,7570,880,23659,1703,1130,2583,3698,868742,-15,10,8.7,1,2,1.3,3,1
42093,180,237,-175,674,40,-57,-135,-194,17860,-2,10,13.2,-9.7,2.2,-3.2,-7.5,6
42095,2787,3201,1019,15032,599,-414,1618,1191,319091,-13,8.8,10.1,3.2,1.9,-1.3,5.1,2
42097,874,1233,327,3313,29,-359,356,-3,90120,0,9.7,13.7,3.6,0.3,-4,4,4
42099,433,544,35,509,45,-111,80,-30,46083,1,9.4,11.8,0.8,1,-2.4,1.7,2
42101,19208,14689,-27667,57609,7038,4519,-20629,-16294,1550542,-184,12.3,9.4,-17.8,4.5,2.9,-13.2,1
42103,420,649,857,463,48,-229,905,671,61247,-5,6.9,10.7,14.1,0.8,-3.8,14.9,6
42105,167,289,-83,213,0,-122,-83,-207,15999,-2,10.4,17.9,-5.2,0,-7.6,-5.2,9
42107,1187,1936,1268,6813,95,-749,1363,598,143786,-16,8.3,13.5,8.8,0.7,-5.2,9.5,4
42109,406,421,207,2362,19,-15,226,211,39717,0,10.2,10.6,5.2,0.5,-0.4,5.7,7
42111,576,1086,72,4210,5,-510,77,-432,72197,1,8,15,1,0.1,-7,1.1,6
42113,37,131,70,298,11,-94,81,-11,5834,2,6.3,22.4,12,1.9,-16.1,13.9,8
42115,360,543,144,319,11,-183,155,-30,38109,-2,9.4,14.2,3.8,0.3,-4.8,4.1,8
42117,373,566,63,1520,3,-193,66,-127,40840,0,9.1,13.8,1.5,0.1,-4.7,1.6,8
42119,345,457,-579,7112,37,-112,-542,-648,42042,6,8.1,10.8,-13.7,0.9,-2.6,-12.8,6
42121,459,805,39,875,8,-346,47,-303,49431,-4,9.3,16.2,0.8,0.2,-7,0.9,4
42123,354,637,27,821,11,-283,38,-246,37572,-1,9.4,16.9,0.7,0.3,-7.5,1,6
42125,1867,2664,996,4629,103,-797,1099,292,210232,-10,8.9,12.7,4.7,0.5,-3.8,5.2,1
42127,396,774,552,3130,2,-378,554,178,51262,2,7.7,15.1,10.8,0,-7.4,10.8,6
42129,2788,4710,1017,6345,90,-1922,1107,-835,351163,-20,7.9,13.4,2.9,0.3,-5.5,3.1,1
42131,249,396,17,609,7,-147,24,-122,25902,1,9.6,15.3,0.7,0.3,-5.7,0.9,2
42133,4812,4706,2889,7978,612,106,3501,3591,464640,-16,10.4,10.2,6.2,1.3,0.2,7.6,2
44000,10006,10434,-3224,44013,5777,-428,2553,2120,1095962,-5,9.1,9.5,-2.9,5.3,-0.4,2.3,
44001,342,573,164,3087,18,-231,182,-52,50255,-3,6.8,11.4,3.3,0.4,-4.6,3.6,1
44003,1458,1977,319,1820,339,-519,658,144,171278,5,8.5,11.5,1.9,2,-3,3.8,1
44005,632,845,-818,4066,147,-213,-671,-889,83832,-5,7.5,10,-9.7,1.7,-2.5,-8,1
44007,6744,5740,-2798,27885,4985,1004,2187,3191,660615,0,10.2,8.7,-4.2,7.6,1.5,3.3,1
44009,830,1299,-91,7155,288,-469,197,-274,129982,-2,6.4,10,-0.7,2.2,-3.6,1.5,1
45000,57581,58852,82562,139093,9291,-1271,91853,90600,5373555,18,10.8,11,15.5,1.7,-0.2,17.2,
45001,217,404,276,840,8,-187,284,96,24434,-1,8.9,16.6,11.3,0.3,-7.7,11.6,6
45003,2272,2225,2727,2703,130,47,2857,2902,177130,-2,12.9,12.7,15.5,0.7,0.3,16.3,2
45005,68,152,33,851,1,-84,34,-49,7369,1,9.2,20.6,4.5,0.1,-11.4,4.6,8
45007,2265,2670,3654,3197,177,-405,3831,3424,213076,-2,10.7,12.6,17.3,0.8,-1.9,18.1,2
45009,133,234,97,846,28,-101,125,24,12974,0,10.3,18.1,7.5,2.2,-7.8,9.6,9
45011,260,315,-2,474,32,-55,30,-24,20447,1,12.7,15.4,-0.1,1.6,-2.7,1.5,8
45013,1910,1906,2420,8026,402,4,2822,2832,198979,6,9.7,9.6,12.2,2,0,14.3,3
45015,2826,1916,8801,4244,534,910,9335,10265,255217,20,11.3,7.7,35.2,2.1,3.6,37.3,2
45017,121,230,97,164,0,-109,97,-11,14186,1,8.5,16.2,6.8,0,-7.7,6.8,2
45019,4931,3397,2440,9214,1028,1534,3468,5017,424367,15,11.7,8.1,5.8,2.4,3.6,8.2,2
45021,659,843,728,1153,51,-184,779,593,56714,-2,11.7,14.9,12.9,0.9,-3.3,13.8,6
45023,334,516,399,206,13,-182,412,233,32226,3,10.4,16.1,12.4,0.4,-5.7,12.8,1
45025,521,649,345,752,74,-128,419,290,44031,-1,11.9,14.8,7.9,1.7,-2.9,9.5,6
45027,287,539,307,1335,19,-252,326,77,31004,3,9.3,17.4,9.9,0.6,-8.1,10.5,8
45029,456,693,470,416,60,-237,530,294,38874,1,11.8,17.9,12.1,1.5,-6.1,13.7,6
45031,726,997,189,1022,61,-271,250,-20,62416,1,11.6,16,3,1,-4.3,4,3
45033,376,478,20,353,32,-102,52,-49,27698,1,13.6,17.2,0.7,1.2,-3.7,1.9,6
45035,1919,1447,3021,1981,303,472,3324,3783,169833,-13,11.4,8.6,18,1.8,2.8,19.8,2
45037,204,363,729,2390,79,-159,808,648,27607,-1,7.5,13.3,26.7,2.9,-5.8,29.6,2
45039,197,377,154,326,-2,-180,152,-28,20422,0,9.6,18.4,7.5,-0.1,-8.8,7.4,2
45041,1568,1806,594,3127,120,-238,714,474,137214,-2,11.4,13.2,4.3,0.9,-1.7,5.2,3
45043,480,968,1512,599,39,-488,1551,1062,65731,-1,7.4,14.8,23.2,0.6,-7.5,23.8,4
45045,6521,5127,6908,10266,1868,1394,8776,10191,558036,21,11.8,9.3,12.5,3.4,2.5,15.9,2
45047,741,948,368,2792,74,-207,442,237,69460,2,10.7,13.7,5.3,1.1,-3,6.4,4
45049,195,289,49,1329,33,-94,82,-14,18122,-2,10.8,15.9,2.7,1.8,-5.2,4.5,8
45051,3199,4611,15061,7940,663,-1412,15724,14331,397478,19,8.2,11.8,38.6,1.7,-3.6,40.3,2
45053,408,385,1429,1176,102,23,1531,1558,33544,4,12.5,11.8,43.6,3.1,0.7,46.7,3
45055,724,915,2209,369,44,-191,2253,2055,69905,-7,10.5,13.3,32.1,0.6,-2.8,32.7,2
45057,1248,1190,3280,1790,153,58,3433,3491,108215,0,11.7,11.2,30.8,1.4,0.5,32.2,1
45059,723,1032,1143,1888,84,-309,1227,922,68873,4,10.6,15.1,16.7,1.2,-4.5,17.9,2
45061,149,293,-112,1492,61,-144,-51,-194,15967,1,9.3,18.2,-7,3.8,-9,-3.2,8
45063,3379,2905,3552,2563,421,474,3973,4423,309528,-24,11,9.5,11.6,1.4,1.5,12.9,2
45065,75,177,300,757,0,-102,300,200,9941,2,7.6,18,30.5,0,-10.4,30.5,8
45067,320,497,214,190,-2,-177,212,37,28508,2,11.2,17.4,7.5,-0.1,-6.2,7.4,6
45069,287,451,-135,2590,-3,-164,-138,-302,25704,0,11.1,17.4,-5.2,-0.1,-6.3,-5.3,6
45071,418,540,535,1458,97,-122,632,510,38825,0,10.8,14,13.9,2.5,-3.2,16.4,6
45073,631,1089,1437,703,85,-458,1522,1061,81221,-3,7.8,13.5,17.8,1.1,-5.7,18.9,4
45075,815,1301,150,4053,53,-486,203,-281,82820,2,9.8,15.7,1.8,0.6,-5.9,2.4,4
45077,1145,1499,2176,9059,206,-354,2382,2025,135495,-3,8.5,11.1,16.2,1.5,-2.6,17.7,2
45079,4599,3522,1512,27316,1019,1077,2531,3612,425138,4,10.9,8.3,3.6,2.4,2.5,6,2
45081,242,276,117,296,56,-34,173,139,19123,0,12.7,14.5,6.1,2.9,-1.8,9.1,2
45083,3840,3772,10060,8173,645,68,10705,10750,356698,-23,10.9,10.7,28.6,1.8,0.2,30.5,2
45085,1310,1364,215,2710,66,-54,281,229,104165,2,12.6,13.1,2.1,0.6,-0.5,2.7,3
45087,243,504,135,403,15,-261,150,-110,26629,1,9.1,18.9,5.1,0.6,-9.8,5.6,2
45089,263,519,0,1623,33,-256,33,-222,29891,1,8.8,17.3,0,1.1,-8.5,1.1,6
45091,3376,2521,2948,3938,329,855,3277,4119,298320,-13,11.4,8.5,10,1.1,2.9,11.1,1
46000,11369,8556,4812,32218,1788,2813,6600,9449,919318,36,12.4,9.4,5.3,2,3.1,7.2,
46003,38,44,20,99,5,-6,25,20,2782,1,13.7,15.9,7.2,1.8,-2.2,9,9
46005,278,179,-252,521,257,99,5,103,19591,-1,14.2,9.2,-12.9,13.2,5.1,0.3,7
46007,50,43,-41,45,5,7,-36,-28,3305,1,15.1,13,-12.4,1.5,2.1,-10.8,9
46009,74,95,17,1374,4,-21,21,1,7065,1,10.5,13.4,2.4,0.6,-3,3,9
46011,385,214,123,3208,193,171,316,489,35980,2,10.8,6,3.4,5.4,4.8,8.8,5
46013,412,363,-277,1156,57,49,-220,-168,37733,3,10.9,9.6,-7.3,1.5,1.3,-5.8,5
46015,63,48,-12,421,7,15,-5,10,5311,0,11.9,9,-2.3,1.3,2.8,-0.9,9
46017,38,41,33,0,0,-3,33,30,1884,0,20.3,21.9,17.7,0,-1.6,17.7,9
46019,135,115,54,104,-2,20,52,73,10863,1,12.5,10.6,5,-0.2,1.8,4.8,7
46021,19,25,-11,0,4,-6,-7,-15,1340,-2,14.1,18.6,-8.2,3,-4.5,-5.2,9
46023,143,93,-47,754,3,50,-44,8,9240,2,15.5,10.1,-5.1,0.3,5.4,-4.8,9
46025,59,35,-22,198,23,24,1,25,3948,0,15,8.9,-5.6,5.8,6.1,0.3,9
46027,137,113,83,2541,23,24,106,130,15431,0,8.9,7.4,5.4,1.5,1.6,6.9,6
46029,326,268,136,498,41,58,177,235,28971,0,11.3,9.3,4.7,1.4,2,6.1,5
46031,78,68,-45,7,0,10,-45,-35,3782,0,20.5,17.9,-11.8,0,2.6,-11.8,9
46033,77,92,107,90,4,-15,111,96,9117,0,8.5,10.1,11.8,0.4,-1.7,12.2,3
46035,229,230,-63,518,79,-1,16,15,19922,0,11.5,11.5,-3.2,4,-0.1,0.8,7
46037,46,77,-1,101,7,-31,6,-24,5451,1,8.4,14.1,-0.2,1.3,-5.7,1.1,9
46039,56,47,-15,52,0,9,-15,-7,4354,-1,12.9,10.8,-3.4,0,2.1,-3.4,9
46041,108,102,61,5,1,6,62,66,5208,-2,20.9,19.7,11.8,0.2,1.2,12,9
46043,45,38,36,116,8,7,44,51,2838,0,16,13.5,12.8,2.8,2.5,15.6,9
46045,56,48,-24,212,2,8,-22,-14,4057,0,13.8,11.8,-5.9,0.5,2,-5.4,9
46047,50,138,86,231,-1,-88,85,-4,7393,-1,6.8,18.7,11.6,-0.1,-11.9,11.5,9
46049,31,31,31,382,0,0,31,29,2151,-2,14.5,14.5,14.5,0,0,14.5,9
46051,94,99,25,243,46,-5,71,67,7553,1,12.5,13.2,3.3,6.1,-0.7,9.4,9
46053,47,54,20,74,7,-7,27,19,4018,-1,11.7,13.5,5,1.7,-1.7,6.7,9
46055,25,26,18,44,0,-1,18,17,1851,0,13.6,14.1,9.8,0,-0.5,9.8,9
46057,140,53,-50,99,20,87,-30,57,6451,0,21.8,8.3,-7.8,3.1,13.5,-4.7,9
46059,39,55,7,61,3,-16,10,-5,3107,1,12.5,17.7,2.3,1,-5.1,3.2,9
46061,39,30,-22,216,5,9,-17,-8,3471,0,11.2,8.6,-6.3,1.4,2.6,-4.9,8
46063,17,6,-27,3,1,11,-26,-15,1324,0,12.8,4.5,-20.3,0.8,8.3,-19.5,9
46065,219,189,-85,774,-3,30,-88,-57,17624,1,12.4,10.7,-4.8,-0.2,1.7,-5,7
46067,96,102,41,826,9,-6,50,43,7394,-1,13,13.8,5.6,1.2,-0.8,6.8,8
46069,13,25,-1,40,0,-12,-1,-13,1186,0,10.9,21,-0.8,0,-10.1,-0.8,9
46071,62,39,-79,32,2,23,-77,-56,2776,-2,22.1,13.9,-28.2,0.7,8.2,-27.5,9
46073,18,18,-3,29,1,0,-2,-2,1660,0,10.8,10.8,-1.8,0.6,0,-1.2,9
46075,8,12,-15,0,0,-4,-15,-20,855,-1,9.2,13.9,-17.3,0,-4.6,-17.3,9
46077,66,72,-1,213,4,-6,3,-3,5276,0,12.5,13.6,-0.2,0.8,-1.1,0.6,9
46079,109,108,83,588,10,1,93,91,11031,-3,9.9,9.8,7.6,0.9,0.1,8.5,6
46081,203,272,857,1034,22,-69,879,813,28053,3,7.3,9.8,31,0.8,-2.5,31.8,6
46083,834,328,1637,260,63,506,1700,2214,73238,8,11.6,4.5,22.7,0.9,7,23.6,2
46085,68,45,-27,88,6,23,-21,0,3705,-2,18.4,12.1,-7.3,1.6,6.2,-5.7,9
46087,80,74,36,212,0,6,36,41,5809,-1,13.8,12.8,6.2,0,1,6.2,2
46089,20,37,-44,205,0,-17,-44,-62,2334,-1,8.5,15.6,-18.6,0,-7.2,-18.6,9
46091,65,56,6,317,13,9,19,27,4390,-1,14.9,12.8,1.4,3,2.1,4.3,9
46093,272,244,212,1027,9,28,221,252,30954,3,8.8,7.9,6.9,0.3,0.9,7.2,3
46095,30,35,-18,43,0,-5,-18,-22,1851,1,16.1,18.8,-9.7,0,-2.7,-9.7,9
46097,27,38,6,65,0,-11,6,-5,2280,0,11.8,16.6,2.6,0,-4.8,2.6,8
46099,2804,1512,1123,5211,649,1292,1772,3085,206930,21,13.7,7.4,5.5,3.2,6.3,8.6,2
46101,93,68,23,79,20,25,43,68,6450,0,14.5,10.6,3.6,3.1,3.9,6.7,8
46102,242,197,-121,404,0,45,-121,-74,13434,2,18,14.6,-9,0,3.3,-9,9
46103,1450,1108,1213,3924,35,342,1248,1597,115903,7,12.6,9.6,10.5,0.3,3,10.8,3
46105,34,38,31,61,0,-4,31,25,2834,-2,12.1,13.5,11,0,-1.4,11,9
46107,23,33,-24,38,0,-10,-24,-33,2413,1,9.5,13.6,-9.9,0,-4.1,-9.9,9
46109,142,112,35,246,2,30,37,67,10206,0,14,11,3.4,0.2,2.9,3.6,9
46111,35,31,-13,40,4,4,-9,-4,2399,1,14.6,12.9,-5.4,1.7,1.7,-3.7,9
46115,75,83,-57,450,4,-8,-53,-62,6166,-1,12.1,13.4,-9.2,0.6,-1.3,-8.6,9
46117,30,32,28,0,0,-2,28,26,3043,0,9.9,10.6,9.2,0,-0.7,9.2,9
46119,12,14,6,0,9,-2,15,12,1494,-1,8.1,9.4,4,6,-1.3,10.1,9
46121,195,119,-140,92,29,76,-111,-34,9199,1,21.2,12.9,-15.2,3.1,8.2,-12,9
46123,66,60,35,245,1,6,36,42,5621,0,11.8,10.7,6.3,0.2,1.1,6.4,9
46125,92,107,117,227,37,-15,154,139,9027,0,10.3,11.9,13.1,4.1,-1.7,17.2,2
46127,192,129,23,95,36,63,59,120,17183,-2,11.2,7.5,1.3,2.1,3.7,3.4,3
46129,76,69,-22,66,-2,7,-24,-17,5269,0,14.4,13.1,-4.2,-0.4,1.3,-4.5,9
46135,243,245,81,1872,25,-2,106,105,23517,1,10.4,10.4,3.5,1.1,-0.1,4.5,7
46137,41,35,-79,42,1,6,-78,-72,2322,0,17.4,14.8,-33.5,0.4,2.5,-33.1,9
47000,82244,81216,63417,148006,13054,1028,76471,77513,7126489,14,11.6,11.5,8.9,1.8,0.1,10.8,
47001,830,1154,1561,1102,64,-324,1625,1305,80234,4,10.4,14.5,19.6,0.8,-4.1,20.4,2
47003,713,612,863,1102,125,101,988,1091,53055,2,13.6,11.7,16.4,2.4,1.9,18.8,4
47005,157,317,267,134,-1,-160,266,109,16103,3,9.8,19.8,16.6,-0.1,-10,16.6,9
47007,132,179,277,1939,5,-47,282,236,15060,1,8.8,12,18.5,0.3,-3.1,18.9,8
47009,1304,1708,2004,1929,47,-404,2051,1646,141456,-1,9.3,12.1,14.2,0.3,-2.9,14.6,2
47011,1183,1423,1062,2048,218,-240,1280,1040,111579,0,10.7,12.8,9.6,2,-2.2,11.5,3
47013,430,711,928,461,10,-281,938,659,40223,2,10.8,17.8,23.3,0.3,-7,23.5,2
47015,183,204,278,108,-1,-21,277,256,15063,0,12.3,13.7,18.6,-0.1,-1.4,18.5,1
47017,274,463,629,1343,3,-189,632,442,28860,-1,9.6,16.2,22,0.1,-6.6,22.1,6
47019,439,858,909,1367,45,-419,954,537,57022,2,7.7,15.1,16,0.8,-7.4,16.8,3
47021,494,535,514,330,15,-41,529,490,42254,2,11.8,12.7,12.2,0.4,-1,12.6,1
47023,180,251,103,1158,15,-71,118,48,17606,1,10.2,14.3,5.9,0.9,-4,6.7,3
47025,338,542,457,1265,42,-204,499,297,32654,2,10.4,16.7,14.1,1.3,-6.3,15.4,6
47027,76,133,99,58,14,-57,113,58,7714,2,9.9,17.3,12.9,1.8,-7.4,14.7,8
47029,373,673,844,228,12,-300,856,555,37404,-1,10,18.1,22.7,0.3,-8.1,23.1,6
47031,702,802,881,743,73,-100,954,854,60633,0,11.7,13.3,14.6,1.2,-1.7,15.8,4
47033,158,208,166,208,1,-50,167,120,13982,3,11.3,14.9,11.9,0.1,-3.6,12,3
47035,532,1120,1863,522,4,-588,1867,1278,64760,-1,8.3,17.5,29.1,0.1,-9.2,29.1,4
47037,10032,5642,-3581,23732,4293,4390,712,4983,712334,-119,14.1,7.9,-5,6,6.2,1,1
47039,105,213,216,144,0,-108,216,107,11656,-1,9,18.4,18.6,0,-9.3,18.6,9
47041,241,328,292,165,16,-87,308,223,21225,2,11.4,15.5,13.8,0.8,-4.1,14.6,8
47043,645,700,1033,767,24,-55,1057,1002,56729,0,11.5,12.4,18.4,0.4,-1,18.8,1
47045,497,593,156,481,0,-96,156,58,36498,-2,13.6,16.3,4.3,0,-2.6,4.3,6
47047,450,534,926,512,-5,-84,921,837,44175,0,10.3,12.2,21.2,-0.1,-1.9,21,1
47049,211,356,500,240,6,-145,506,361,19696,0,10.8,18.2,25.6,0.3,-7.4,25.9,8
47051,438,599,635,2532,58,-161,693,535,44654,3,9.9,13.5,14.3,1.3,-3.6,15.6,7
47053,629,860,439,811,8,-231,447,219,51045,3,12.3,16.9,8.6,0.2,-4.5,8.8,3
47055,304,492,348,772,17,-188,365,181,30721,4,9.9,16.1,11.4,0.6,-6.1,11.9,6
47057,266,377,606,155,0,-111,606,496,24681,1,10.9,15.4,24.8,0,-4.5,24.8,2
47059,647,1145,1776,1984,12,-498,1788,1285,72577,-5,9,15.9,24.7,0.2,-6.9,24.9,4
47061,169,239,245,184,-2,-70,243,176,13955,3,12.2,17.2,17.7,-0.1,-5,17.5,8
47063,773,998,1170,469,102,-225,1272,1049,66216,2,11.8,15.2,17.8,1.6,-3.4,19.4,3
47065,4500,3913,3942,7999,703,587,4645,5262,379864,30,11.9,10.4,10.4,1.9,1.6,12.3,2
47067,56,127,181,154,0,-71,181,110,6956,0,8.1,18.4,26.2,0,-10.3,26.2,8
47069,282,376,153,3750,-1,-94,152,56,25567,-2,11,14.7,6,0,-3.7,6,6
47071,286,491,372,443,-3,-205,369,164,27229,0,10.5,18.1,13.7,-0.1,-7.6,13.6,6
47073,500,940,1132,432,2,-440,1134,697,58600,3,8.6,16.1,19.4,0,-7.6,19.5,2
47075,196,279,-112,197,3,-83,-109,-190,17328,2,11.2,16,-6.4,0.2,-4.8,-6.3,6
47077,307,414,274,367,-2,-107,272,163,28070,-2,11,14.8,9.8,-0.1,-3.8,9.7,6
47079,314,521,382,312,-4,-207,378,172,32554,1,9.7,16,11.8,-0.1,-6.4,11.6,7
47081,278,362,414,1354,16,-84,430,345,25826,-1,10.8,14.1,16.1,0.6,-3.3,16.8,1
47083,78,138,208,131,0,-60,208,146,8393,-2,9.4,16.6,25,0,-7.2,25,8
47085,198,337,320,425,5,-139,325,186,19209,0,10.4,17.6,16.7,0.3,-7.3,17,8
47087,104,175,421,139,1,-71,422,348,12363,-3,8.5,14.4,34.5,0.1,-5.8,34.6,8
47089,542,794,1370,1536,58,-252,1428,1178,57838,2,9.5,13.9,23.9,1,-4.4,24.9,3
47091,148,293,454,1569,19,-145,473,329,18375,1,8.1,16.1,24.9,1,-8,26,8
47093,5444,5082,4080,15035,818,362,4898,5289,500669,29,10.9,10.2,8.2,1.6,0.7,9.8,2
47095,64,144,-75,1707,2,-80,-73,-153,6347,0,10,22.4,-11.7,0.3,-12.5,-11.4,9
47097,332,351,-112,1806,0,-19,-112,-131,24610,0,13.5,14.2,-4.5,0,-0.8,-4.5,6
47099,590,637,653,464,4,-47,657,612,46114,2,12.9,13.9,14.3,0.1,-1,14.3,6
47101,118,219,242,186,13,-101,255,154,13066,0,9.1,16.9,18.6,1,-7.8,19.6,8
47103,421,511,235,261,18,-90,253,163,36169,0,11.7,14.2,6.5,0.5,-2.5,7,6
47105,539,766,2507,506,68,-227,2575,2347,60591,-1,9.1,12.9,42.2,1.1,-3.8,43.3,2
47107,604,855,1222,929,16,-251,1238,983,55678,-4,10.9,15.5,22.1,0.3,-4.5,22.4,4
47109,309,442,286,288,17,-133,303,170,26163,0,11.8,16.9,11,0.7,-5.1,11.6,8
47111,296,327,589,264,22,-31,611,579,26793,-1,11.2,12.3,22.2,0.8,-1.2,23.1,1
47113,1169,1193,-85,4324,127,-24,42,21,99193,3,11.8,12,-0.9,1.3,-0.2,0.4,3
47115,290,437,473,129,5,-147,478,332,29382,1,9.9,15,16.2,0.2,-5,16.4,2
47117,429,441,1091,236,30,-12,1121,1104,36961,-5,11.8,12.1,30,0.8,-0.3,30.8,6
47119,1331,1106,2532,1267,4,225,2536,2764,110760,3,12.2,10.1,23.1,0,2.1,23.2,1
47121,117,206,521,113,0,-89,521,433,13691,1,8.7,15.3,38.7,0,-6.6,38.7,8
47123,508,736,1136,425,4,-228,1140,914,48594,2,10.6,15.3,23.6,0.1,-4.7,23.7,6
47125,3722,1743,2767,4446,185,1979,2952,4973,239872,42,15.7,7.3,11.7,0.8,8.3,12.4,2
47127,53,95,73,48,-1,-42,72,32,6748,2,7.9,14.1,10.8,-0.1,-6.2,10.7,9
47129,195,319,494,1868,0,-124,494,366,21573,-4,9.1,14.9,23.1,0,-5.8,23.1,2
47131,363,471,145,234,0,-108,145,37,30411,0,11.9,15.5,4.8,0,-3.6,4.8,7
47133,242,394,484,153,0,-152,484,334,23327,2,10.4,17,20.9,0,-6.6,20.9,9
47135,103,145,221,148,7,-42,228,186,8891,0,11.7,16.5,25.1,0.8,-4.8,25.9,9
47137,31,77,71,54,-1,-46,70,25,5128,1,6.1,15.1,13.9,-0.2,-9,13.7,9
47139,166,330,416,197,-1,-164,415,255,18033,4,9.3,18.4,23.2,-0.1,-9.2,23.2,3
47141,943,931,1193,3394,167,12,1360,1374,83844,2,11.3,11.2,14.3,2,0.1,16.4,4
47143,372,518,369,622,7,-146,376,235,33924,5,11,15.3,10.9,0.2,-4.3,11.1,6
47145,507,845,1311,409,-7,-338,1304,967,56096,1,9.1,15.2,23.6,-0.1,-6.1,23.4,2
47147,897,870,1299,641,49,27,1348,1378,76776,3,11.8,11.4,17.1,0.6,0.4,17.7,1
47149,4256,2548,3518,5338,1192,1708,4710,6419,367101,1,11.7,7,9.7,3.3,4.7,12.9,1
47151,266,358,264,227,-2,-92,262,172,22171,2,12,16.2,12,-0.1,-4.2,11.9,8
47153,196,216,214,332,49,-20,263,243,17161,0,11.5,12.7,12.6,2.9,-1.2,15.4,2
47155,1072,1301,509,495,333,-229,842,609,99415,-4,10.8,13.1,5.1,3.4,-2.3,8.5,4
47157,12539,9509,-11684,12504,2301,3030,-9383,-6315,910042,38,13.7,10.4,-12.8,2.5,3.3,-10.3,1
47159,231,276,106,175,6,-45,112,68,20538,1,11.3,13.5,5.2,0.3,-2.2,5.5,1
47161,130,205,305,203,-3,-75,302,228,14222,1,9.2,14.5,21.6,-0.2,-5.3,21.4,2
47163,1501,2347,2091,2267,31,-846,2122,1273,162135,-3,9.3,14.5,12.9,0.2,-5.2,13.1,2
47165,2242,2057,3885,1492,202,185,4087,4273,207994,1,10.9,10,18.9,1,0.9,19.9,1
47167,692,757,422,827,9,-65,431,365,62015,-1,11.2,12.2,6.8,0.1,-1.1,7,1
47169,115,147,225,2512,-2,-32,223,194,12271,3,9.4,12.1,18.5,-0.2,-2.6,18.3,1
47171,141,368,391,376,3,-227,394,165,17756,-2,8,20.8,22.1,0.2,-12.8,22.3,3
47173,231,333,369,129,-2,-102,367,268,20741,3,11.2,16.2,17.9,-0.1,-4.9,17.8,2
47175,67,145,141,69,-2,-78,139,63,6493,2,10.4,22.4,21.8,-0.3,-12.1,21.5,9
47177,547,567,594,418,60,-20,654,637,42638,3,12.9,13.4,14,1.4,-0.5,15.5,6
47179,1260,1702,2514,5546,200,-442,2714,2273,138420,1,9.2,12.4,18.3,1.5,-3.2,19.8,3
47181,148,252,-90,1784,-5,-104,-95,-200,16066,-1,9.2,15.6,-5.6,-0.3,-6.4,-5.9,8
47183,340,469,155,2226,12,-129,167,41,33084,3,10.3,14.2,4.7,0.4,-3.9,5.1,6
47185,287,453,861,158,0,-166,861,692,28692,-3,10.1,16,30.4,0,-5.9,30.4,7
47187,2415,1499,2110,1265,746,916,2856,3722,264460,-50,9.2,5.7,8,2.8,3.5,10.9,1
47189,1719,1387,4402,1708,356,332,4758,5081,163674,-9,10.7,8.6,27.3,2.2,2.1,29.5,1
48000,390494,232241,186767,605204,128534,158253,315301,473453,30503301,-101,12.9,7.7,6.2,4.2,5.2,10.4,
48001,594,802,614,12904,107,-208,721,509,57736,-4,10.3,14,10.7,1.9,-3.6,12.5,7
48003,292,152,131,64,69,140,200,340,18664,0,15.8,8.2,7.1,3.7,7.6,10.8,6
48005,1178,1102,101,2641,13,76,114,195,87319,5,13.5,12.6,1.2,0.1,0.9,1.3,5
48007,235,412,590,445,-4,-177,586,411,25374,2,9.3,16.4,23.4,-0.2,-7,23.3,2
48009,90,109,194,56,7,-19,201,180,9029,-2,10.1,12.2,21.7,0.8,-2.1,22.5,3
48011,23,30,-19,39,0,-7,-19,-25,1832,1,12.5,16.3,-10.3,0,-3.8,-10.3,2
48013,624,551,996,312,-17,73,979,1048,51784,-4,12.2,10.7,19.4,-0.3,1.4,19.1,1
48015,390,343,559,229,3,47,562,607,31677,-2,12.4,10.9,17.8,0.1,1.5,17.9,1
48017,113,76,-243,117,77,37,-166,-131,6672,-2,16.8,11.3,-36.1,11.4,5.5,-24.6,6
48019,192,314,620,221,20,-122,640,517,22637,-1,8.6,14,27.7,0.9,-5.5,28.6,1
48021,1321,852,3854,2091,73,469,3927,4383,110778,-13,12.2,7.8,35.5,0.7,4.3,36.2,1
48023,34,79,32,55,14,-45,46,1,3463,0,9.8,22.8,9.2,4,-13,13.3,9
48025,313,374,-95,7946,11,-61,-84,-142,30850,3,10.1,12.1,-3.1,0.4,-2,-2.7,6
48027,6539,2880,1337,8024,712,3659,2049,5739,393193,31,16.8,7.4,3.4,1.8,9.4,5.2,2
48029,26765,15947,10831,40262,5705,10818,16536,27488,2087679,134,12.9,7.7,5.2,2.8,5.2,8,1
48031,87,155,706,75,0,-68,706,637,13048,-1,6.8,12.2,55.5,0,-5.3,55.5,8
48033,5,7,-6,0,0,-2,-6,-8,572,0,8.7,12.2,-10.4,0,-3.5,-10.4,9
48035,196,294,373,212,17,-98,390,289,18996,-3,10.4,15.6,19.8,0.9,-5.2,20.7,2
48037,1101,1208,-7,5032,85,-107,78,-25,91687,4,12,13.2,-0.1,0.9,-1.2,0.9,3
48039,4834,2959,7888,9285,955,1875,8843,10704,398938,-14,12.3,7.5,20,2.4,4.8,22.5,1
48041,2885,1276,184,20865,966,1609,1150,2772,244703,13,11.9,5.2,0.8,4,6.6,4.7,2
48043,90,109,148,505,40,-19,188,169,9513,0,9.5,11.6,15.7,4.2,-2,19.9,7
48045,10,16,12,0,0,-6,12,6,1445,0,6.9,11.1,8.3,0,-4.2,8.3,8
48047,101,98,-91,463,38,3,-53,-54,6848,-4,14.7,14.3,-13.2,5.5,0.4,-7.7,9
48049,468,588,345,1678,38,-120,383,266,38709,3,12.1,15.2,8.9,1,-3.1,9.9,5
48051,216,283,783,144,71,-67,854,785,19475,-2,11.3,14.8,41,3.7,-3.5,44.8,2
48053,531,620,1508,1035,3,-89,1511,1424,53991,2,10,11.6,28.3,0.1,-1.7,28.4,6
48055,646,458,1735,2460,86,188,1821,2010,49859,1,13.2,9.4,35.5,1.8,3.8,37.3,1
48057,238,260,-1,317,38,-22,37,14,19696,-1,12.1,13.2,-0.1,1.9,-1.1,1.9,6
48059,143,215,198,80,3,-72,201,127,14374,-2,10,15,13.8,0.2,-5,14,3
48061,6022,3228,-1860,4416,833,2794,-1027,1799,426710,32,14.1,7.6,-4.4,2,6.6,-2.4,2
48063,209,226,270,46,26,-17,296,279,13000,0,16.3,17.6,21,2,-1.3,23,8
48065,69,82,77,29,1,-13,78,62,5878,-3,11.8,14,13.2,0.2,-2.2,13.3,2
48067,365,548,311,328,-4,-183,307,121,28659,-3,12.8,19.2,10.9,-0.1,-6.4,10.7,6
48069,115,94,-107,109,24,21,-83,-60,7227,2,15.8,13,-14.7,3.3,2.9,-11.4,9
48071,611,394,2273,211,89,217,2362,2567,53876,-12,11.6,7.5,43.2,1.7,4.1,44.9,1
48073,682,715,814,2170,5,-33,819,785,52217,-1,13.2,13.8,15.7,0.1,-0.6,15.8,6
48075,66,81,-47,1302,9,-15,-38,-53,6788,0,9.7,11.9,-6.9,1.3,-2.2,-5.6,9
48077,115,148,264,58,10,-33,274,239,10738,-2,10.8,13.9,24.9,0.9,-3.1,25.8,3
48079,51,43,-37,8,17,8,-20,-13,2509,-1,20.3,17.1,-14.7,6.8,3.2,-8,2
48081,39,65,59,72,0,-26,59,30,3352,-3,11.7,19.5,17.7,0,-7.8,17.7,8
48083,94,204,133,33,-2,-110,131,20,7842,-1,12,26,17,-0.3,-14,16.7,8
48085,12840,5299,20749,9069,8137,7541,28886,36364,1195359,-63,10.9,4.5,17.6,6.9,6.4,24.5,1
48087,36,41,-16,9,-1,-5,-17,-22,2563,0,14,15.9,-6.2,-0.4,-1.9,-6.6,9
48089,294,327,271,418,48,-33,319,285,21117,-1,14,15.6,12.9,2.3,-1.6,15.2,8
48091,1822,1550,8891,1486,45,272,8936,9179,193928,-29,9.6,8.2,47,0.2,1.4,47.2,1
48093,186,206,135,127,13,-20,148,129,14050,1,13.3,14.7,9.7,0.9,-1.4,10.6,9
48095,25,33,-82,1054,20,-8,-62,-70,3297,0,7.5,9.9,-24.6,6,-2.4,-18.6,8
48097,580,475,609,744,22,105,631,734,43782,-2,13.4,10.9,14,0.5,2.4,14.5,6
48099,1058,641,100,12042,156,417,256,673,84878,0,12.5,7.6,1.2,1.8,4.9,3,2
48101,10,21,-11,0,0,-11,-11,-23,1294,-1,7.7,16.1,-8.4,0,-8.4,-8.4,9
48103,67,48,6,88,-2,19,4,23,4574,0,14.7,10.5,1.3,-0.4,4.2,0.9,8
48105,56,55,-98,43,-4,1,-102,-102,2858,-1,19.3,18.9,-33.7,-1.4,0.3,-35.1,8
48107,67,98,-55,65,11,-31,-44,-75,4917,0,13.5,19.8,-11.1,2.2,-6.3,-8.9,2
48109,31,31,32,48,1,0,33,33,2196,0,14.2,14.2,14.7,0.5,0,15.1,9
48111,191,77,-209,27,98,114,-111,2,7237,-1,26.4,10.6,-28.9,13.5,15.8,-15.3,7
48113,36886,17336,-34330,31833,19273,19550,-15057,4365,2606358,-128,14.2,6.7,-13.2,7.4,7.5,-5.8,1
48115,185,159,-206,1680,10,26,-196,-172,12004,-2,15.3,13.2,-17,0.8,2.2,-16.2,6
48117,328,209,-223,154,52,119,-171,-52,18347,0,17.9,11.4,-12.1,2.8,6.5,-9.3,6
48119,65,85,127,50,1,-20,128,107,5520,-1,11.9,15.5,23.2,0.2,-3.7,23.4,8
48121,11361,4558,19262,9380,3828,6803,23090,29943,1007703,50,11.4,4.6,19.4,3.9,6.9,23.3,1
48123,216,280,236,1542,4,-64,240,175,19929,-1,10.9,14.1,11.9,0.2,-3.2,12.1,6
48125,20,29,-18,4,3,-9,-15,-25,1711,-1,11.6,16.8,-10.4,1.7,-5.2,-8.7,8
48127,143,150,-94,182,-2,-7,-96,-103,8257,0,17.2,18.1,-11.3,-0.2,-0.8,-11.6,7
48129,36,61,-55,293,5,-25,-50,-75,3214,0,11.1,18.8,-16.9,1.5,-7.7,-15.4,8
48131,147,169,-80,714,0,-22,-80,-102,9604,0,15.2,17.5,-8.3,0,-2.3,-8.3,9
48133,225,359,254,727,25,-134,279,144,18037,-1,12.5,20,14.1,1.4,-7.5,15.5,8
48135,2987,1399,891,2508,959,1588,1850,3437,164494,-1,18.4,8.6,5.5,5.9,9.8,11.4,3
48137,20,31,-24,13,0,-11,-24,-35,1393,0,14.2,22,-17,0,-7.8,-17,9
48139,2721,1594,9247,1856,171,1127,9418,10506,222829,-39,12.5,7.3,42.5,0.8,5.2,43.3,1
48141,11089,6332,-3840,14728,1683,4757,-2157,2641,869880,41,12.8,7.3,-4.4,1.9,5.5,-2.5,2
48143,501,423,261,3744,20,78,281,358,44195,-1,11.4,9.6,5.9,0.5,1.8,6.4,5
48145,179,231,366,1788,18,-52,384,330,17286,-2,10.5,13.5,21.4,1.1,-3,22.4,2
48147,365,543,668,3131,5,-178,673,496,37571,1,9.8,14.5,17.9,0.1,-4.8,18,6
48149,259,360,622,379,25,-101,647,540,25474,-6,10.3,14.3,24.7,1,-4,25.7,6
48151,28,62,16,23,4,-34,20,-14,3612,0,7.7,17.1,4.4,1.1,-9.4,5.5,8
48153,58,89,-115,23,-2,-31,-117,-149,5090,-1,11.2,17.2,-22.3,-0.4,-6,-22.7,8
48155,9,25,33,32,0,-16,33,16,1079,-1,8.4,23.3,30.8,0,-14.9,30.8,9
48157,9567,4178,15757,4705,6834,5389,22591,27859,916778,-121,10.6,4.6,17.5,7.6,6,25,1
48159,104,127,72,67,20,-23,92,70,10735,1,9.7,11.9,6.7,1.9,-2.1,8.6,9
48161,239,242,401,1593,14,-3,415,409,20441,-3,11.8,12,19.8,0.7,-0.1,20.5,9
48163,231,206,47,2749,197,25,244,271,17987,2,12.9,11.5,2.6,11,1.4,13.7,6
48165,482,166,10,135,55,316,65,383,22523,2,21.6,7.4,0.4,2.5,14.2,2.9,6
48167,4053,3171,2988,4992,505,882,3493,4357,361744,-18,11.3,8.8,8.3,1.4,2.5,9.7,1
48169,53,64,-26,452,57,-11,31,19,4517,-1,11.8,14.2,-5.8,12.6,-2.4,6.9,2
48171,246,384,263,305,109,-138,372,232,27733,-2,8.9,13.9,9.5,3.9,-5,13.5,7
48173,14,11,-2,0,1,3,-1,2,1141,0,12.3,9.6,-1.8,0.9,2.6,-0.9,8
48175,68,99,54,92,-1,-31,53,24,7144,2,9.5,13.9,7.6,-0.1,-4.3,7.4,3
48177,292,256,63,273,14,36,77,114,19930,1,14.7,12.9,3.2,0.7,1.8,3.9,6
48179,244,336,-14,1548,41,-92,27,-64,20916,1,11.6,16,-0.7,2,-4.4,1.3,6
48181,1846,1706,3441,2123,132,140,3573,3709,146907,-4,12.7,11.8,23.7,0.9,1,24.6,3
48183,1744,1585,357,3421,164,159,521,684,126243,4,13.9,12.6,2.8,1.3,1.3,4.1,2
48185,415,370,1172,2813,-1,45,1171,1214,32384,-2,13.1,11.6,36.9,0,1.4,36.9,6
48187,1920,1409,5213,1787,42,511,5255,5752,188454,-14,10.3,7.6,28.1,0.2,2.8,28.3,1
48189,407,372,-314,2011,72,35,-242,-205,31761,2,12.8,11.7,-9.9,2.3,1.1,-7.6,4
48191,31,49,0,32,19,-18,19,0,2818,-1,11,17.4,0,6.7,-6.4,6.7,9
48193,94,143,335,154,21,-49,356,306,8619,-1,11.1,16.9,39.6,2.5,-5.8,42.1,8
48195,68,61,-44,57,-3,7,-47,-40,5071,0,13.4,12,-8.6,-0.6,1.4,-9.2,9
48197,46,44,-46,13,8,2,-38,-35,3490,1,13.1,12.5,-13.1,2.3,0.6,-10.8,9
48199,732,720,392,394,25,12,417,421,58261,-8,12.6,12.4,6.8,0.4,0.2,7.2,2
48201,65450,30755,-22792,50587,41665,34695,18873,53788,4835125,220,13.6,6.4,-4.7,8.7,7.2,3.9,1
48203,883,849,801,2411,25,34,826,857,70895,-3,12.5,12,11.4,0.4,0.5,11.7,2
48205,74,45,-117,866,6,29,-111,-83,5145,-1,14.3,8.7,-22.6,1.2,5.6,-21.4,9
48207,47,110,61,498,11,-63,72,9,5385,0,8.7,20.4,11.3,2,-11.7,13.4,8
48209,3072,1448,9286,7796,456,1624,9742,11383,280486,17,11.2,5.3,33.8,1.7,5.9,35.5,1
48211,37,23,-48,71,-1,14,-49,-36,3189,-1,11.5,7.2,-15,-0.3,4.4,-15.3,9
48213,964,1349,2040,1171,15,-385,2055,1668,86158,-2,11.3,15.8,23.9,0.2,-4.5,24.1,4
48215,13671,5383,139,8001,1695,8288,1834,10185,898471,63,15.3,6,0.2,1.9,9.3,2.1,2
48217,468,612,942,458,37,-144,979,835,38101,0,12.4,16.2,25,1,-3.8,26,6
48219,284,283,161,290,20,1,181,182,21460,0,13.3,13.2,7.5,0.9,0,8.5,2
48221,691,871,1547,863,18,-180,1565,1380,67774,-5,10.3,13,23.1,0.3,-2.7,23.3,4
48223,480,486,329,449,58,-6,387,379,38172,-2,12.6,12.8,8.7,1.5,-0.2,10.2,6
48225,269,367,205,2408,16,-98,221,123,22066,0,12.2,16.7,9.3,0.7,-4.5,10,7
48227,376,427,-201,2344,70,-51,-131,-178,30554,4,12.3,13.9,-6.6,2.3,-1.7,-4.3,4
48229,32,39,-67,1032,109,-7,42,35,3451,0,9.3,11.4,-19.5,31.7,-2,12.2,2
48231,1397,1133,4530,2980,133,264,4663,4909,113347,-18,12.6,10.2,40.9,1.2,2.4,42,1
48233,237,339,-81,284,-6,-102,-87,-189,20033,0,11.8,16.8,-4,-0.3,-5.1,-4.3,6
48235,21,23,17,3,0,-2,17,15,1549,0,13.6,14.9,11,0,-1.3,11,3
48237,93,105,115,907,9,-12,124,111,8875,-1,10.5,11.9,13,1,-1.4,14.1,8
48239,243,161,-55,360,10,82,-45,38,15221,1,16,10.6,-3.6,0.7,5.4,-3,6
48241,418,544,294,464,32,-126,326,199,32694,-1,12.8,16.7,9,1,-3.9,10,6
48243,12,26,-35,0,-2,-14,-37,-50,1856,1,6.4,13.8,-18.6,-1.1,-7.4,-19.7,9
48245,3260,2714,-1291,14262,627,546,-664,-105,251496,13,13,10.8,-5.1,2.5,2.2,-2.6,2
48247,80,67,-65,77,0,13,-65,-54,4720,-2,16.9,14.1,-13.7,0,2.7,-13.7,8
48249,506,527,-55,333,8,-21,-47,-67,38662,1,13.1,13.6,-1.4,0.2,-0.5,-1.2,6
48251,2454,1737,6591,3214,121,717,6712,7410,202906,-19,12.3,8.7,33.1,0.6,3.6,33.7,1
48253,163,248,190,5598,6,-85,196,110,20381,-1,8,12.2,9.3,0.3,-4.2,9.6,3
48255,158,170,-31,3195,115,-12,84,73,15018,1,10.5,11.3,-2.1,7.7,-0.8,5.6,8
48257,2412,1287,11819,1568,179,1125,11998,13079,185690,-44,13.5,7.2,66,1,6.3,67,1
48259,455,425,1429,846,71,30,1500,1518,50537,-12,9.1,8.5,28.7,1.4,0.6,30.1,1
48261,2,2,-10,3,0,0,-10,-11,343,-1,5.7,5.7,-28.7,0,0,-28.7,9
48263,9,20,1,45,0,-11,1,-10,734,0,12.2,27.1,1.4,0,-14.9,1.4,9
48265,509,775,363,1922,33,-266,396,131,53915,1,9.5,14.4,6.7,0.6,-4.9,7.4,4
48267,39,63,46,12,0,-24,46,22,4442,0,8.8,14.2,10.4,0,-5.4,10.4,9
48269,2,0,-19,0,0,2,-19,-17,217,0,8.9,0,-84.3,0,8.9,-84.3,9
48271,28,55,30,463,14,-27,44,17,3148,0,8.9,17.5,9.6,4.5,-8.6,14,9
48273,364,319,-418,1309,63,45,-355,-307,30069,3,12,10.6,-13.8,2.1,1.5,-11.7,4
48275,40,68,45,97,3,-28,48,18,3302,-2,12.1,20.6,13.7,0.9,-8.5,14.6,9
48277,708,739,590,742,60,-31,650,612,51127,-7,13.9,14.5,11.6,1.2,-0.6,12.8,5
48279,169,171,-109,174,35,-2,-74,-75,12711,1,13.3,13.4,-8.6,2.7,-0.2,-5.8,6
48281,213,321,564,190,16,-108,580,472,23262,0,9.3,13.9,24.5,0.7,-4.7,25.2,2
48283,77,83,-49,1443,36,-6,-13,-19,6537,0,11.8,12.7,-7.5,5.5,-0.9,-2,8
48285,252,281,-54,373,1,-29,-53,-82,20571,0,12.2,13.6,-2.6,0,-1.4,-2.6,8
48287,204,198,267,371,-3,6,264,269,18240,-1,11.3,10.9,14.7,-0.2,0.3,14.6,8
48289,189,259,381,36,9,-70,390,318,16538,-2,11.5,15.8,23.3,0.5,-4.3,23.8,8
48291,1415,1015,5395,4842,52,400,5447,5810,108272,-37,13.4,9.6,51.2,0.5,3.8,51.7,1
48293,260,366,175,1093,16,-106,191,86,22250,1,11.7,16.5,7.9,0.7,-4.8,8.6,6
48295,40,39,48,35,11,1,59,60,2906,0,13.9,13.6,16.7,3.8,0.3,20.5,9
48297,94,153,57,1647,45,-59,102,43,11584,0,8.1,13.2,4.9,3.9,-5.1,8.8,8
48299,229,375,360,170,37,-146,397,252,22875,1,10.1,16.5,15.8,1.6,-6.4,17.5,7
48301,0,2,1,0,0,-2,1,-1,43,0,0,46,23,0,-46,23,9
48303,4122,2879,988,11421,931,1243,1919,3179,320940,17,12.9,9,3.1,2.9,3.9,6,2
48305,84,87,25,38,2,-3,27,23,5761,-1,14.6,15.1,4.3,0.3,-0.5,4.7,2
48307,72,156,70,80,-1,-84,69,-16,7452,-1,9.7,20.9,9.4,-0.1,-11.3,9.2,9
48309,3619,2517,924,9666,378,1102,1302,2421,268583,17,13.5,9.4,3.5,1.4,4.1,4.9,2
48311,5,14,10,0,0,-9,10,-1,568,-2,8.8,24.6,17.6,0,-15.8,17.6,8
48313,190,169,42,2179,37,21,79,101,13742,1,13.9,12.3,3.1,2.7,1.5,5.8,8
48315,93,208,133,106,3,-115,136,21,9571,0,9.7,21.8,13.9,0.3,-12,14.2,8
48317,79,53,-41,12,4,26,-37,-12,5216,-1,15.1,10.1,-7.9,0.8,5,-7.1,3
48319,34,63,-17,1,0,-29,-17,-47,3931,-1,8.6,15.9,-4.3,0,-7.3,-4.3,9
48321,557,442,-28,344,150,115,122,237,36359,0,15.4,12.2,-0.8,4.1,3.2,3.4,6
48323,978,527,-442,429,120,451,-322,134,57762,5,17,9.1,-7.7,2.1,7.8,-5.6,3
48325,628,524,1029,2358,11,104,1040,1140,54797,-4,11.6,9.7,19,0.2,1.9,19.2,1
48327,18,38,-2,34,1,-20,-1,-21,1958,0,9.1,19.3,-1,0.5,-10.2,-0.5,9
48329,3029,1244,2584,1764,727,1785,3311,5089,177108,-7,17.4,7.1,14.8,4.2,10.2,19,3
48331,302,393,416,409,6,-91,422,329,25951,-2,11.7,15.2,16.1,0.2,-3.5,16.4,6
48333,44,89,91,176,5,-45,96,50,4548,-1,9.7,19.7,20.1,1.1,-9.9,21.2,9
48335,72,103,158,2220,11,-31,169,137,9075,-1,8,11.4,17.5,1.2,-3.4,18.8,7
48337,210,349,651,220,9,-139,660,519,21598,-2,9.8,16.4,30.5,0.4,-6.5,30.9,6
48339,8570,4559,25501,4259,2365,4011,27866,31800,711354,-77,12.3,6.6,36.7,3.4,5.8,40.1,1
48341,441,189,-350,122,191,252,-159,96,21190,3,20.9,8.9,-16.6,9,11.9,-7.5,7
48343,123,218,87,89,22,-95,109,14,12066,0,10.2,18.1,7.2,1.8,-7.9,9,8
48345,13,30,4,0,0,-17,4,-14,1020,-1,12.7,29.2,3.9,0,-16.6,3.9,8
48347,888,722,171,4285,42,166,213,381,65375,2,13.6,11.1,2.6,0.6,2.5,3.3,5
48349,757,619,789,1252,25,138,814,948,55635,-4,13.7,11.2,14.3,0.5,2.5,14.8,4
48351,116,217,98,45,0,-101,98,-2,12039,1,9.6,18,8.1,0,-8.4,8.1,8
48353,178,209,-148,284,26,-31,-122,-154,14306,-1,12.4,14.5,-10.3,1.8,-2.2,-8.5,6
48355,4500,3406,-932,7491,518,1094,-414,699,352289,19,12.8,9.7,-2.6,1.5,3.1,-1.2,2
48357,145,88,-169,38,126,57,-43,12,9704,-2,15,9.1,-17.4,13,5.9,-4.4,7
48359,25,19,4,243,13,6,17,22,1783,-1,14.1,10.7,2.3,7.3,3.4,9.6,2
48361,1132,1075,568,517,57,57,625,674,85722,-8,13.3,12.6,6.7,0.7,0.7,7.3,2
48363,360,426,482,268,9,-66,491,425,29747,0,12.2,14.4,16.3,0.3,-2.2,16.6,6
48365,281,344,160,340,0,-63,160,96,22838,-1,12.3,15.1,7,0,-2.8,7,6
48367,1868,1386,6960,1316,128,482,7088,7556,173494,-14,11,8.2,41,0.8,2.8,41.8,1
48369,164,103,-142,94,48,61,-94,-32,9617,1,17,10.7,-14.7,5,6.3,-9.8,9
48371,189,169,-141,1903,32,20,-109,-88,14623,1,12.9,11.5,-9.6,2.2,1.4,-7.4,7
48373,579,844,1185,3825,7,-265,1192,930,54186,3,10.8,15.7,22.1,0.1,-4.9,22.2,6
48375,1692,1402,-994,6386,444,290,-550,-264,114647,-4,14.7,12.2,-8.7,3.9,2.5,-4.8,2
48377,90,70,-226,46,49,20,-177,-159,5795,-2,15.3,11.9,-38.5,8.3,3.4,-30.1,9
48379,111,198,230,59,6,-87,236,150,12986,1,8.6,15.3,17.8,0.5,-6.7,18.3,8
48381,1852,1300,1284,2534,173,552,1457,2011,148255,2,12.6,8.8,8.7,1.2,3.7,9.9,2
48383,47,32,-9,0,13,15,4,20,3141,1,15,10.2,-2.9,4.2,4.8,1.3,8
48385,31,61,51,65,0,-30,51,22,2854,1,10.9,21.5,17.9,0,-10.6,17.9,9
48387,140,225,144,156,13,-85,157,73,11678,1,12,19.3,12.4,1.1,-7.3,13.5,8
48389,187,151,0,463,44,36,44,78,11770,-2,15.9,12.9,0,3.8,3.1,3.8,7
48391,54,110,84,78,0,-56,84,28,6666,0,8.1,16.5,12.6,0,-8.4,12.6,8
48393,14,7,21,0,0,7,21,28,840,0,16.9,8.5,25.4,0,8.5,25.4,9
48395,211,260,187,159,-3,-49,184,137,17267,2,12.3,15.1,10.9,-0.2,-2.8,10.7,2
48397,1367,781,7267,723,156,586,7423,7965,131307,-44,10.7,6.1,57.1,1.2,4.6,58.3,1
48399,122,187,44,179,5,-65,49,-16,9868,0,12.4,18.9,4.5,0.5,-6.6,5,8
48401,534,694,676,4747,41,-160,717,555,53079,-2,10.1,13.1,12.8,0.8,-3,13.6,2
48403,108,237,190,124,5,-129,195,65,10106,-1,10.7,23.5,18.9,0.5,-12.8,19.4,9
48405,90,182,68,220,-2,-92,66,-27,7833,-1,11.5,23.2,8.7,-0.3,-11.7,8.4,9
48407,307,449,737,136,3,-142,740,596,28936,-2,10.7,15.7,25.7,0.1,-5,25.8,1
48409,936,760,250,353,145,176,395,573,70660,2,13.3,10.8,3.6,2.1,2.5,5.6,2
48411,54,85,-7,697,3,-31,-4,-35,5845,0,9.2,14.5,-1.2,0.5,-5.3,-0.7,9
48413,39,33,26,31,0,6,26,32,2391,0,16.4,13.9,10.9,0,2.5,10.9,8
48415,201,211,-91,963,42,-10,-49,-57,16212,2,12.4,13,-5.6,2.6,-0.6,-3,7
48417,33,41,24,33,1,-8,25,17,3229,0,10.2,12.7,7.5,0.3,-2.5,7.8,8
48419,398,367,99,119,-13,31,86,118,24179,1,16.5,15.2,4.1,-0.5,1.3,3.6,7
48421,45,31,-115,25,1,14,-114,-100,2678,0,16.5,11.4,-42.2,0.4,5.1,-41.8,9
48423,3049,2544,2426,5523,278,505,2704,3214,245209,5,12.5,10.4,10,1.1,2.1,11.1,3
48425,103,116,83,127,20,-13,103,91,9888,1,10.5,11.8,8.4,2,-1.3,10.5,8
48427,1100,559,-278,348,13,541,-265,281,65934,5,16.7,8.5,-4.2,0.2,8.2,-4,4
48429,89,141,23,921,-4,-52,19,-34,9343,-1,9.5,15.1,2.5,-0.4,-5.6,2,7
48431,33,16,-46,31,0,17,-46,-29,1397,0,23.4,11.3,-32.6,0,12,-32.6,8
48433,10,21,13,58,0,-11,13,0,1218,-2,8.2,17.2,10.7,0,-9,10.7,9
48435,37,47,-23,5,21,-10,-2,-11,3221,1,11.5,14.6,-7.1,6.5,-3.1,-0.6,9
48437,83,94,-29,653,36,-11,7,-4,6955,0,11.9,13.5,-4.2,5.2,-1.6,1,8
48439,28006,14996,5354,28347,8805,13010,14159,27301,2182947,132,12.9,6.9,2.5,4.1,6,6.5,1
48441,2015,1590,733,6318,527,425,1260,1689,146836,4,13.8,10.9,5,3.6,2.9,8.6,3
48443,5,20,14,0,0,-15,14,-1,687,0,7.3,29.1,20.4,0,-21.8,20.4,9
48445,178,146,32,567,38,32,70,103,11547,1,15.5,12.7,2.8,3.3,2.8,6.1,6
48447,13,23,-5,0,2,-10,-3,-13,1526,0,8.5,15,-3.3,1.3,-6.5,-2,9
48449,479,336,-86,238,61,143,-25,120,31357,2,15.3,10.7,-2.7,1.9,4.6,-0.8,7
48451,1516,1267,-241,3449,136,249,-105,144,119057,0,12.7,10.6,-2,1.1,2.1,-0.9,3
48453,16289,6312,-10479,34552,8068,9977,-2411,7411,1334961,-155,12.2,4.7,-7.9,6.1,7.5,-1.8,1
48455,147,306,390,108,6,-159,396,235,14228,-2,10.4,21.7,27.6,0.4,-11.3,28.1,8
48457,210,375,124,2310,13,-165,137,-29,20382,-1,10.3,18.4,6.1,0.6,-8.1,6.7,8
48459,496,600,917,437,18,-104,935,827,43281,-4,11.6,14,21.4,0.4,-2.4,21.8,2
48461,27,31,-34,63,1,-4,-33,-37,3109,0,8.6,9.9,-10.9,0.3,-1.3,-10.6,8
48463,407,324,-90,841,76,83,-14,70,24960,1,16.3,13,-3.6,3,3.3,-0.6,6
48465,829,457,-376,1971,107,372,-269,103,47720,0,17.4,9.6,-7.9,2.2,7.8,-5.6,5
48467,655,875,1329,569,10,-220,1339,1112,64000,-7,10.3,13.8,20.9,0.2,-3.5,21.1,8
48469,1299,1004,244,1113,49,295,293,590,91664,2,14.2,11,2.7,0.5,3.2,3.2,3
48471,697,654,1335,19978,204,43,1539,1590,81268,8,8.7,8.1,16.6,2.5,0.5,19.1,4
48473,761,482,1338,6205,83,279,1421,1701,63553,1,12.1,7.7,21.3,1.3,4.4,22.7,1
48475,173,119,-37,93,1,54,-36,18,10966,0,15.8,10.9,-3.4,0.1,4.9,-3.3,6
48477,381,479,712,2298,26,-98,738,639,37007,-1,10.4,13.1,19.4,0.7,-2.7,20.1,6
48479,4420,1664,-2054,4011,795,2756,-1259,1529,269148,32,16.5,6.2,-7.7,3,10.3,-4.7,2
48481,555,534,-67,572,42,21,-25,-1,41739,3,13.3,12.8,-1.6,1,0.5,-0.6,4
48483,64,91,31,56,13,-27,44,17,4804,0,13.3,19,6.5,2.7,-5.6,9.2,9
48485,1742,1539,-480,11332,234,203,-246,-40,130180,3,13.4,11.8,-3.7,1.8,1.6,-1.9,3
48487,184,191,-16,842,10,-7,-6,-13,12522,0,14.7,15.2,-1.3,0.8,-0.6,-0.5,6
48489,245,212,-258,2692,10,33,-248,-217,20037,-2,12.2,10.5,-12.8,0.5,1.6,-12.3,6
48491,8043,3494,17943,4687,2390,4549,20333,24918,697191,36,11.7,5.1,26.2,3.5,6.6,29.7,1
48493,592,582,1370,422,57,10,1427,1429,54183,-8,11.1,10.9,25.6,1.1,0.2,26.7,1
48495,127,85,60,152,14,42,74,114,7414,-2,17.3,11.6,8.2,1.9,5.7,10.1,6
48497,915,743,3008,843,31,172,3039,3200,78097,-11,12,9.7,39.3,0.4,2.2,39.7,1
48499,416,806,1295,1553,90,-390,1385,991,47921,-4,8.8,17,27.3,1.9,-8.2,29.2,6
48501,132,80,-144,57,73,52,-71,-16,7468,3,17.7,10.7,-19.3,9.8,7,-9.5,9
48503,237,306,175,232,8,-69,183,112,18124,-2,13.1,16.9,9.7,0.4,-3.8,10.1,7
48505,209,141,-188,101,20,68,-168,-102,13736,-2,15.2,10.2,-13.6,1.5,4.9,-12.2,6
48507,169,148,-97,43,3,21,-94,-72,9312,1,18.1,15.8,-10.4,0.3,2.2,-10.1,7
49000,45965,21169,1338,55398,10285,24796,11623,36498,3417734,79,13.5,6.2,0.4,3,7.3,3.4,
49001,106,77,-123,379,10,29,-113,-84,7233,0,14.6,10.6,-16.9,1.4,4,-15.5,9
49003,831,480,773,327,36,351,809,1161,62684,1,13.4,7.7,12.4,0.6,5.7,13,4
49005,2122,729,515,4609,333,1393,848,2248,142393,7,15,5.2,3.6,2.4,9.9,6,3
49007,226,291,135,250,2,-65,137,69,20609,-3,11,14.1,6.6,0.1,-3.2,6.7,7
49009,10,7,-27,0,0,3,-27,-23,992,1,10,7,-26.9,0,3,-26.9,9
49011,4769,2122,132,2161,511,2647,643,3320,373207,30,12.8,5.7,0.4,1.4,7.1,1.7,2
49013,281,177,232,183,1,104,233,335,20477,-2,13.8,8.7,11.4,0,5.1,11.5,7
49015,124,126,41,61,11,-2,52,51,10144,1,12.3,12.5,4.1,1.1,-0.2,5.1,9
49017,58,61,60,269,0,-3,60,56,5314,-1,11,11.5,11.4,0,-0.6,11.4,9
49019,98,85,-104,154,26,13,-78,-65,9706,0,10.1,8.7,-10.7,2.7,1.3,-8,7
49021,823,419,1136,1676,161,404,1297,1703,64211,2,13,6.6,17.9,2.5,6.4,20.5,4
49023,201,89,326,102,3,112,329,437,13023,-4,15.7,7,25.5,0.2,8.7,25.7,2
49025,93,101,231,217,1,-8,232,222,8425,-2,11.2,12.1,27.8,0.1,-1,27.9,8
49027,180,133,40,127,6,47,46,94,13437,1,13.4,9.9,3,0.4,3.5,3.4,9
49029,139,70,90,28,6,69,96,163,13000,-2,10.8,5.4,7,0.5,5.3,7.4,2
49031,18,24,64,0,0,-6,64,57,1550,-1,11.8,15.8,42.1,0,-3.9,42.1,9
49033,28,18,11,56,-1,10,10,21,2670,1,10.5,6.8,4.1,-0.4,3.8,3.8,8
49035,14841,7436,-14070,17818,5951,7405,-8119,-756,1185813,-42,12.5,6.3,-11.9,5,6.2,-6.8,1
49037,185,156,-96,381,17,29,-79,-48,14358,2,12.9,10.8,-6.7,1.2,2,-5.5,9
49039,382,270,431,2938,46,112,477,586,30277,-3,12.7,9,14.4,1.5,3.7,15.9,6
49041,284,226,248,371,-3,58,245,301,22344,-2,12.8,10.2,11.2,-0.1,2.6,11,7
49043,418,210,-613,133,115,208,-498,-286,42759,4,9.7,4.9,-14.3,2.7,4.8,-11.6,4
49045,1070,491,1464,516,56,579,1520,2096,82051,-3,13.2,6.1,18.1,0.7,7.1,18.8,1
49047,497,318,413,114,50,179,463,643,37747,1,13.3,8.5,11,1.3,4.8,12.4,7
49049,11955,3065,5130,15667,2381,8890,7511,16482,719174,81,16.8,4.3,7.2,3.3,12.5,10.6,2
49051,383,187,214,236,137,196,351,547,37144,0,10.4,5.1,5.8,3.7,5.3,9.5,4
49053,2298,1762,4023,3211,173,536,4196,4722,202452,-10,11.5,8.8,20.1,0.9,2.7,21,3
49055,32,33,-17,0,-1,-1,-18,-20,2614,-1,12.2,12.6,-6.5,-0.4,-0.4,-6.9,9
49057,3513,2006,679,3414,257,1507,936,2466,271926,23,13,7.4,2.5,0.9,5.6,3.5,2
5000,35566,36473,18106,85120,4096,-907,22202,21328,3067732,33,11.6,11.9,5.9,1.3,-0.3,7.3,
50000,5072,6876,844,24942,1312,-1804,2156,354,647464,2,7.8,10.6,1.3,2,-2.8,3.3,
50001,289,373,153,3018,96,-84,249,165,37720,0,7.7,9.9,4.1,2.6,-2.2,6.6,6
50003,263,545,47,1459,77,-282,124,-160,37183,-2,7.1,14.6,1.3,2.1,-7.6,3.3,6
50005,239,397,175,1059,6,-158,181,23,30610,0,7.8,13,5.7,0.2,-5.2,5.9,9
50007,1334,1297,-789,9901,872,37,83,124,169481,4,7.9,7.7,-4.7,5.1,0.2,0.5,3
50009,56,89,46,50,0,-33,46,13,6010,0,9.3,14.8,7.7,0,-5.5,7.7,9
5001,186,305,-71,322,-1,-119,-72,-191,16307,0,11.3,18.6,-4.3,-0.1,-7.3,-4.4,6
50011,524,473,202,676,20,51,222,275,50994,2,10.3,9.3,4,0.4,1,4.4,3
50013,62,101,13,0,3,-39,16,-23,7467,0,8.3,13.5,1.7,0.4,-5.2,2.1,3
50015,208,251,-67,626,65,-43,-2,-43,26060,2,8,9.6,-2.6,2.5,-1.6,-0.1,8
50017,248,307,102,647,19,-59,121,63,29943,1,8.3,10.3,3.4,0.6,-2,4,9
50019,208,437,187,736,-4,-229,183,-46,27516,0,7.6,15.9,6.8,-0.1,-8.3,6.6,9
50021,444,790,261,1880,3,-346,264,-82,60271,0,7.4,13.1,4.3,0,-5.7,4.4,7
50023,443,609,157,2331,39,-166,196,27,60142,-3,7.4,10.1,2.6,0.6,-2.8,3.3,4
50025,336,529,229,1817,32,-193,261,67,45966,-1,7.3,11.5,5,0.7,-4.2,5.7,7
50027,418,678,128,742,84,-260,212,-49,58101,-1,7.2,11.7,2.2,1.4,-4.5,3.6,7
5003,199,315,36,154,-2,-116,34,-86,18262,-4,10.9,17.2,2,-0.1,-6.3,1.9,7
5005,349,801,843,522,-4,-452,839,390,42875,3,8.2,18.8,19.8,-0.1,-10.6,19.7,7
5007,3908,2211,5376,3030,1096,1697,6472,8191,311013,22,12.7,7.2,17.5,3.6,5.5,21.1,2
5009,406,526,376,445,-2,-120,374,250,38530,-4,10.6,13.7,9.8,-0.1,-3.1,9.7,7
5011,118,154,-24,218,-5,-36,-29,-64,10104,1,11.6,15.2,-2.4,-0.5,-3.6,-2.9,7
5013,51,88,-8,149,0,-37,-8,-46,4641,-1,10.9,18.9,-1.7,0,-7.9,-1.7,9
5015,326,371,104,230,36,-45,140,97,28814,2,11.3,12.9,3.6,1.3,-1.6,4.9,6
5017,88,173,-209,690,-1,-85,-210,-296,9538,-1,9.1,17.9,-21.6,-0.1,-8.8,-21.7,9
5019,239,289,40,2767,8,-50,48,-2,21274,0,11.2,13.6,1.9,0.4,-2.4,2.3,7
5021,157,242,17,151,-2,-85,15,-70,14201,0,11,17,1.2,-0.1,-6,1.1,9
5023,223,427,399,259,-3,-204,396,192,25445,0,8.8,16.8,15.7,-0.1,-8,15.6,6
5025,82,129,-41,72,1,-47,-40,-89,7378,-2,11,17.4,-5.5,0.1,-6.3,-5.4,8
5027,256,298,-114,1902,20,-42,-94,-136,22150,0,11.5,13.4,-5.1,0.9,-1.9,-4.2,7
5029,228,298,98,171,26,-70,124,56,21077,2,10.8,14.2,4.7,1.2,-3.3,5.9,6
5031,1540,1091,617,3181,61,449,678,1130,113993,3,13.6,9.6,5.4,0.5,4,6,3
5033,727,779,752,673,151,-52,903,850,61891,-1,11.8,12.7,12.2,2.5,-0.8,14.7,3
5035,570,620,106,586,32,-50,138,88,47139,0,12.1,13.2,2.3,0.7,-1.1,2.9,1
5037,183,265,-120,145,30,-82,-90,-170,16420,2,11.1,16.1,-7.3,1.8,-5,-5.5,6
5039,57,120,54,232,-1,-63,53,-11,6185,-1,9.2,19.4,8.7,-0.2,-10.2,8.6,8
5041,113,164,-235,42,9,-51,-226,-279,10479,-2,10.6,15.4,-22.1,0.8,-4.8,-21.3,9
5043,193,226,56,590,9,-33,65,33,16945,1,11.4,13.4,3.3,0.5,-1.9,3.8,7
5045,1468,1117,1892,5105,145,351,2037,2386,129951,-2,11.4,8.7,14.7,1.1,2.7,15.8,2
5047,188,258,270,277,0,-70,270,198,17468,-2,10.8,14.9,15.5,0,-4,15.5,8
5049,117,235,184,162,-1,-118,183,66,12421,1,9.4,19,14.9,-0.1,-9.5,14.8,9
5051,970,1535,295,1652,74,-565,369,-198,99784,-2,9.7,15.4,3,0.7,-5.7,3.7,3
5053,184,258,324,152,7,-74,331,254,18383,-3,10.1,14.1,17.7,0.4,-4.1,18.1,2
5055,526,562,361,849,6,-36,367,335,46743,4,11.3,12.1,7.8,0.1,-0.8,7.9,4
5057,214,281,-91,293,17,-67,-74,-138,19343,3,11,14.5,-4.7,0.9,-3.5,-3.8,6
5059,304,475,279,2577,-1,-171,278,109,33258,2,9.2,14.3,8.4,0,-5.2,8.4,6
5061,139,175,-58,172,4,-36,-54,-89,12533,1,11.1,13.9,-4.6,0.3,-2.9,-4.3,8
5063,474,487,78,1183,2,-13,80,66,38320,-1,12.4,12.7,2,0.1,-0.3,2.1,7
5065,113,238,266,1210,-2,-125,264,140,14169,1,8,16.9,18.9,-0.1,-8.9,18.7,9
5067,157,252,217,2498,7,-95,224,130,16784,1,9.4,15.1,13,0.4,-5.7,13.4,6
5069,723,916,-524,5488,83,-193,-441,-634,63661,0,11.3,14.3,-8.2,1.3,-3,-6.9,4
5071,296,334,177,541,20,-38,197,159,26129,0,11.4,12.8,6.8,0.8,-1.5,7.6,7
5073,42,106,3,59,28,-64,31,-34,6095,-1,6.9,17.3,0.5,4.6,-10.5,5.1,8
5075,192,239,164,549,9,-47,173,124,16318,-2,11.8,14.7,10.1,0.6,-2.9,10.6,6
5077,82,139,-118,1709,11,-57,-107,-166,8201,-2,9.9,16.8,-14.2,1.3,-6.9,-12.9,8
5079,100,170,59,4001,-2,-70,57,-12,12898,1,7.7,13.2,4.6,-0.2,-5.4,4.4,9
5081,95,194,41,174,-2,-99,39,-60,11805,0,8,16.4,3.5,-0.2,-8.4,3.3,3
5083,260,362,244,370,2,-102,246,142,21400,-2,12.2,17,11.4,0.1,-4.8,11.5,8
5085,886,789,606,720,43,97,649,745,75944,-1,11.7,10.4,8,0.6,1.3,8.6,2
5087,217,248,331,149,13,-31,344,312,17775,-1,12.3,14.1,18.8,0.7,-1.8,19.5,2
5089,137,301,392,159,-2,-164,390,225,17514,-1,7.9,17.3,22.5,-0.1,-9.4,22.4,9
5091,356,573,52,1511,-29,-217,23,-193,42415,1,8.4,13.5,1.2,-0.7,-5.1,0.5,3
5093,526,571,-173,840,17,-45,-156,-200,38663,1,13.6,14.7,-4.5,0.4,-1.2,-4,4
5095,86,134,-8,79,0,-48,-8,-56,6512,0,13.1,20.5,-1.2,0,-7.3,-1.2,9
5097,80,162,163,118,-1,-82,162,77,8620,-3,9.3,18.9,19,-0.1,-9.6,18.9,8
5099,75,121,-10,194,-2,-46,-12,-59,8120,-1,9.2,14.8,-1.2,-0.2,-5.6,-1.5,9
51000,95669,79980,-6985,235956,28117,15689,21132,36599,8715698,-222,11,9.2,-0.8,3.2,1.8,2.4,
51001,359,532,121,384,68,-173,189,16,33239,0,10.8,16,3.6,2,-5.2,5.7,9
51003,1047,916,299,7500,405,131,704,831,115676,-4,9.1,7.9,2.6,3.5,1.1,6.1,3
51005,79,301,102,285,1,-222,103,-120,14595,-1,5.4,20.5,7,0.1,-15.1,7,6
51007,123,219,203,94,6,-96,209,112,13480,-1,9.2,16.3,15.1,0.4,-7.2,15.6,1
51009,275,464,99,735,14,-189,113,-76,31396,0,8.7,14.8,3.1,0.4,-6,3.6,2
5101,67,123,26,65,0,-56,26,-30,7071,0,9.5,17.4,3.7,0,-7.9,3.7,9
51011,190,194,163,80,1,-4,164,161,16864,1,11.3,11.6,9.7,0.1,-0.2,9.8,2
51013,2601,974,-2979,2847,1838,1627,-1141,484,234162,-2,11.1,4.2,-12.7,7.9,7,-4.9,1
51015,521,886,641,2997,33,-365,674,308,78247,-1,6.7,11.3,8.2,0.4,-4.7,8.6,3
51017,43,75,22,57,1,-32,23,-10,4051,-1,10.6,18.5,5.4,0.2,-7.9,5.7,9
51019,644,970,1085,515,35,-326,1120,784,81525,-10,7.9,12,13.4,0.4,-4,13.8,2
51021,32,102,113,683,0,-70,113,41,6179,-2,5.2,16.6,18.3,0,-11.4,18.3,8
51023,263,456,214,384,9,-193,223,25,34125,-5,7.7,13.4,6.3,0.3,-5.7,6.5,2
51025,118,267,59,2007,9,-149,68,-82,15749,-1,7.5,16.9,3.7,0.6,-9.4,4.3,8
51027,181,379,-104,1286,5,-198,-99,-296,19087,1,9.4,19.7,-5.4,0.3,-10.3,-5.1,9
51029,133,222,77,2211,0,-89,77,-10,16978,2,7.8,13.1,4.5,0,-5.2,4.5,8
5103,247,370,-79,371,0,-123,-79,-201,21793,1,11.3,16.9,-3.6,0,-5.6,-3.6,7
51031,375,712,525,789,17,-337,542,205,55270,0,6.8,12.9,9.5,0.3,-6.1,9.8,2
51033,354,371,692,500,26,-17,718,700,32640,-1,11,11.5,21.4,0.8,-0.5,22.2,8
51035,269,502,344,163,10,-233,354,121,29239,0,9.2,17.2,11.8,0.3,-8,12.1,6
51036,37,114,120,0,0,-77,120,42,6610,-1,5.6,17.3,18.2,0,-11.7,18.2,1
51037,146,235,28,129,-2,-89,26,-64,11336,-1,12.8,20.7,2.5,-0.2,-7.8,2.3,8
51041,4144,2935,3635,5263,767,1209,4402,5586,383876,-25,10.9,7.7,9.5,2,3.2,11.6,1
51043,159,181,154,241,3,-22,157,135,15466,0,10.3,11.8,10,0.2,-1.4,10.2,1
51045,45,73,13,0,0,-28,13,-15,4843,0,9.3,15,2.7,0,-5.8,2.7,2
51047,664,529,438,1431,113,135,551,683,54973,-3,12.2,9.7,8,2.1,2.5,10.1,1
51049,84,131,167,21,9,-47,176,127,9878,-2,8.6,13.3,17,0.9,-4.8,17.9,8
5105,99,151,157,90,6,-52,163,111,10184,0,9.8,14.9,15.5,0.6,-5.1,16.1,2
51051,120,220,4,402,4,-100,8,-93,13640,-1,8.8,16.1,0.3,0.3,-7.3,0.6,9
51053,182,364,409,411,18,-182,427,244,28343,-1,6.4,12.9,14.5,0.6,-6.4,15.1,1
51057,113,183,35,75,3,-70,38,-32,10598,0,10.6,17.2,3.3,0.3,-6.6,3.6,8
51059,12496,5120,-13405,11560,8536,7376,-4869,2569,1141878,62,11,4.5,-11.8,7.5,6.5,-4.3,1
51061,742,662,350,399,68,80,418,488,75165,-10,9.9,8.8,4.7,0.9,1.1,5.6,1
51063,111,213,150,111,10,-102,160,56,15679,-2,7.1,13.6,9.6,0.6,-6.5,10.2,3
51065,259,285,371,1192,1,-26,372,345,28462,-1,9.2,10.1,13.1,0,-0.9,13.1,3
51067,509,739,669,1227,31,-230,700,470,55549,0,9.2,13.4,12.1,0.6,-4.2,12.7,2
51069,902,918,1113,1049,96,-16,1209,1186,95994,-7,9.5,9.6,11.7,1,-0.2,12.7,3
5107,208,278,-350,215,31,-70,-319,-389,14961,0,13.7,18.3,-23.1,2,-4.6,-21,7
51071,150,289,167,125,-1,-139,166,25,16457,-2,9.1,17.6,10.2,-0.1,-8.5,10.1,3
51073,369,474,614,303,1,-105,615,507,40057,-3,9.3,11.9,15.4,0,-2.6,15.5,1
51075,211,272,1097,920,4,-61,1101,1035,27197,-5,7.9,10.2,41.1,0.1,-2.3,41.3,1
51077,119,267,110,1095,1,-148,111,-40,15285,-3,7.8,17.4,7.2,0.1,-9.7,7.3,9
51079,237,230,270,159,7,7,277,286,21301,2,11.2,10.9,12.8,0.3,0.3,13.1,3
51081,96,158,-9,3291,-1,-62,-10,-71,11133,1,8.6,14.1,-0.8,-0.1,-5.6,-0.9,6
51083,332,592,70,623,2,-260,72,-188,33432,0,9.9,17.7,2.1,0.1,-7.8,2.1,6
51085,1066,1145,1346,2070,33,-79,1379,1288,114148,-12,9.4,10.1,11.9,0.3,-0.7,12.1,1
51087,3690,3111,-1760,4586,1386,579,-374,207,334760,2,11,9.3,-5.3,4.1,1.7,-1.1,1
51089,393,908,431,689,-1,-515,430,-93,49702,-8,7.9,18.3,8.7,0,-10.4,8.6,4
5109,113,170,105,221,2,-57,107,49,10208,-1,11.1,16.7,10.3,0.2,-5.6,10.5,9
51091,18,33,61,0,-1,-15,60,43,2339,-2,7.8,14.2,26.3,-0.4,-6.5,25.9,8
51093,408,459,564,199,65,-51,629,576,40711,-2,10.1,11.4,14,1.6,-1.3,15.6,1
51095,822,774,1003,1397,133,48,1136,1171,82654,-13,10,9.4,12.2,1.6,0.6,13.8,1
51097,47,102,60,0,0,-55,60,6,6720,1,7,15.2,8.9,0,-8.2,8.9,1
51099,321,204,511,202,21,117,532,650,28568,1,11.4,7.2,18.1,0.7,4.1,18.8,8
51101,245,221,470,70,9,24,479,501,19030,-2,13,11.8,25,0.5,1.3,25.5,1
51103,73,228,205,228,4,-155,209,53,10859,-1,6.7,21,18.9,0.4,-14.3,19.3,9
51105,173,385,106,1480,3,-212,109,-102,21745,1,7.9,17.7,4.9,0.1,-9.7,5,8
51107,4924,1620,-1762,1237,1962,3304,200,3555,436347,51,11.3,3.7,-4.1,4.5,7.6,0.5,1
51109,416,472,1018,99,44,-56,1062,1007,41037,1,10.3,11.6,25.1,1.1,-1.4,26.2,8
5111,292,398,15,313,35,-106,50,-56,22397,0,13,17.7,0.7,1.6,-4.7,2.2,3
51111,115,171,75,984,18,-56,93,36,12038,-1,9.6,14.2,6.2,1.5,-4.7,7.7,9
51113,128,172,139,242,26,-44,165,120,14128,-1,9.1,12.2,9.9,1.8,-3.1,11.7,8
51115,63,171,174,97,0,-108,174,64,8514,-2,7.4,20.2,20.5,0,-12.7,20.5,1
51117,301,540,295,910,64,-239,359,121,30648,1,9.8,17.7,9.6,2.1,-7.8,11.7,7
51119,90,206,56,373,32,-116,88,-28,10924,0,8.2,18.8,5.1,2.9,-10.6,8,8
51121,634,763,-623,10921,584,-129,-39,-160,98666,8,6.4,7.7,-6.3,5.9,-1.3,-0.4,3
51125,166,207,-22,68,22,-41,0,-42,14705,-1,11.3,14.1,-1.5,1.5,-2.8,0,3
51127,253,245,1172,591,1,8,1173,1182,26134,1,9.9,9.6,45.9,0,0.3,45.9,1
5113,202,316,208,96,11,-114,219,102,19436,-3,10.4,16.3,10.7,0.6,-5.9,11.3,7
51131,114,212,117,268,24,-98,141,43,12021,0,9.5,17.7,9.8,2,-8.2,11.8,8
51133,85,232,261,0,-2,-147,259,113,12391,1,6.9,18.8,21.2,-0.2,-11.9,21,9
51135,169,253,86,2338,11,-84,97,11,15566,-2,10.9,16.3,5.5,0.7,-5.4,6.2,8
51137,438,455,526,240,9,-17,535,519,38574,1,11.4,11.9,13.7,0.2,-0.4,14,6
51139,213,335,67,203,18,-122,85,-36,23741,1,9,14.1,2.8,0.8,-5.1,3.6,8
51141,160,345,94,351,-1,-185,93,-92,17509,0,9.1,19.7,5.4,-0.1,-10.5,5.3,8
51143,406,812,158,1293,-1,-406,157,-253,59571,-4,6.8,13.6,2.6,0,-6.8,2.6,4
51145,285,304,521,1069,20,-19,541,520,32105,-2,8.9,9.5,16.4,0.6,-0.6,17,1
51147,207,266,175,4417,33,-59,208,150,22049,1,9.4,12.1,8,1.5,-2.7,9.5,6
51149,369,363,-211,9253,54,6,-157,-150,42871,1,8.6,8.5,-4.9,1.3,0.1,-3.7,1
5115,729,682,478,2603,23,47,501,540,64593,-8,11.3,10.6,7.4,0.4,0.7,7.8,5
51153,6230,2324,-3991,2967,2658,3906,-1333,2628,489640,55,12.8,4.8,-8.2,5.4,8,-2.7,1
51155,296,536,206,1059,5,-240,211,-28,33655,1,8.8,15.9,6.1,0.1,-7.1,6.3,3
51157,35,94,24,4,-3,-59,21,-39,7414,-1,4.7,12.6,3.2,-0.4,-7.9,2.8,1
51159,93,128,80,1548,15,-35,95,58,9184,-2,10.2,14,8.7,1.6,-3.8,10.4,9
51161,700,1145,612,2151,110,-445,722,270,97026,-7,7.2,11.8,6.3,1.1,-4.6,7.5,2
51163,98,327,18,490,3,-229,21,-210,22358,-2,4.4,14.6,0.8,0.1,-10.2,0.9,6
51165,917,923,1012,2278,155,-6,1167,1154,86568,-7,10.7,10.7,11.8,1.8,-0.1,13.6,3
51167,265,436,209,311,3,-171,212,40,25477,-1,10.4,17.1,8.2,0.1,-6.7,8.3,8
51169,178,377,155,772,0,-199,155,-47,21433,-3,8.3,17.6,7.2,0,-9.3,7.2,2
5117,79,143,23,135,-1,-64,22,-41,8036,1,9.8,17.7,2.9,-0.1,-7.9,2.7,8
51171,472,588,328,451,81,-116,409,292,45228,-1,10.5,13,7.3,1.8,-2.6,9.1,6
51173,280,559,74,538,13,-279,87,-192,29216,0,9.6,19.1,2.5,0.4,-9.5,3,7
51175,108,257,227,1444,-1,-149,226,76,17975,-1,6,14.3,12.7,-0.1,-8.3,12.6,6
51177,1569,1112,2102,322,224,457,2326,2760,149588,-23,10.6,7.5,14.2,1.5,3.1,15.7,1
51179,1772,945,1029,3172,431,827,1460,2259,165428,-28,10.8,5.8,6.3,2.6,5,8.9,1
51181,68,106,105,0,-1,-38,104,66,6593,0,10.4,16.2,16,-0.2,-5.8,15.9,1
51183,85,178,212,2131,0,-93,212,117,10757,-2,7.9,16.6,19.8,0,-8.7,19.8,1
51185,242,731,31,1734,16,-489,47,-443,39120,-1,6.2,18.6,0.8,0.4,-12.4,1.2,7
51187,451,506,414,1130,82,-55,496,439,41843,-2,10.8,12.2,9.9,2,-1.3,11.9,1
5119,5002,4064,-804,9372,489,938,-315,622,400009,-1,12.5,10.2,-2,1.2,2.3,-0.8,2
51191,453,806,548,1958,6,-353,554,195,54050,-6,8.4,14.9,10.2,0.1,-6.5,10.3,2
51193,170,258,340,81,-5,-88,335,248,19013,1,9,13.7,18,-0.3,-4.7,17.7,8
51195,353,608,105,2639,-1,-255,104,-153,35174,-2,10,17.2,3,0,-7.2,3,7
51197,282,471,178,150,0,-189,178,-11,28104,0,10,16.8,6.3,0,-6.7,6.3,6
51199,604,588,-308,1031,79,16,-229,-212,70952,1,8.5,8.3,-4.3,1.1,0.2,-3.2,1
5121,246,265,41,338,32,-19,73,55,18907,1,13,14,2.2,1.7,-1,3.9,7
5123,269,329,-282,3436,42,-60,-240,-301,22101,-1,12.1,14.8,-12.7,1.9,-2.7,-10.8,6
5125,1414,1385,2050,1290,86,29,2136,2159,129574,-6,11,10.8,16,0.7,0.2,16.6,2
5127,122,178,107,130,1,-56,108,55,9851,3,12.4,18.1,10.9,0.1,-5.7,11,8
5129,74,154,-21,59,1,-80,-20,-100,7806,0,9.4,19.6,-2.7,0.1,-10.2,-2.5,9
5131,1604,1511,-286,2012,181,93,-105,-11,129098,1,12.4,11.7,-2.2,1.4,0.7,-0.8,3
5133,180,201,-91,110,5,-21,-86,-106,15632,1,11.5,12.8,-5.8,0.3,-1.3,-5.5,6
5135,180,302,254,179,0,-122,254,132,17968,0,10.1,16.9,14.2,0,-6.8,14.2,9
5137,126,220,188,136,-6,-94,182,86,12671,-2,10,17.4,14.9,-0.5,-7.4,14.4,9
5139,462,573,-358,618,53,-111,-305,-416,37397,0,12.3,15.2,-9.5,1.4,-3,-8.1,7
5141,140,298,189,61,7,-158,196,39,16142,1,8.7,18.5,11.7,0.4,-9.8,12.2,8
5143,3279,1869,2296,11102,1125,1410,3421,4867,261549,36,12.7,7.2,8.9,4.3,5.4,13.2,2
5145,902,990,886,2496,42,-88,928,836,78452,-4,11.6,12.7,11.4,0.5,-1.1,11.9,4
5147,70,102,-61,108,0,-32,-61,-93,5964,0,11.6,17,-10.1,0,-5.3,-10.1,9
5149,254,277,-53,242,27,-23,-26,-47,20044,2,12.7,13.8,-2.6,1.3,-1.1,-1.3,9
51510,2284,902,-2570,1383,1428,1382,-1142,185,155230,-55,14.7,5.8,-16.6,9.2,8.9,-7.4,1
51520,185,302,-8,296,-6,-117,-14,-133,16807,-2,11,17.9,-0.5,-0.4,-6.9,-0.8,2
51530,79,109,33,568,-6,-30,27,-3,6566,0,12,16.6,5,-0.9,-4.6,4.1,6
51540,575,365,-694,2416,192,210,-502,-289,44983,3,12.7,8.1,-15.4,4.3,4.7,-11.1,3
51550,2985,2166,235,4009,379,819,614,1427,253886,-6,11.8,8.6,0.9,1.5,3.2,2.4,1
51570,271,308,147,194,7,-37,154,115,18393,-2,14.8,16.8,8,0.4,-2,8.4,1
51580,73,122,-43,77,4,-49,-39,-88,5545,0,13.1,21.8,-7.7,0.7,-8.8,-7,6
51590,435,854,212,1487,29,-419,241,-180,41837,-2,10.4,20.4,5.1,0.7,-10,5.7,4
51595,67,103,-36,196,2,-36,-34,-70,5463,0,12.2,18.7,-6.5,0.4,-6.5,-6.2,6
51600,595,300,-189,323,286,295,97,392,25144,0,23.8,12,-7.6,11.5,11.8,3.9,1
51610,173,166,140,177,50,7,190,196,14685,-1,11.9,11.4,9.6,3.4,0.5,13,1
51620,157,179,87,111,0,-22,87,65,8339,0,18.9,21.5,10.5,0,-2.6,10.5,6
51630,348,305,16,2322,221,43,237,280,28928,0,12.1,10.6,0.6,7.7,1.5,8.2,1
51640,120,169,68,276,-3,-49,65,15,6717,-1,17.9,25.2,10.1,-0.4,-7.3,9.7,6
51650,1637,1504,-1071,3534,180,133,-891,-760,137098,-2,11.9,10.9,-7.8,1.3,1,-6.5,1
51660,595,355,-736,7334,425,240,-311,-68,51082,3,11.6,6.9,-14.4,8.3,4.7,-6.1,3
51670,317,418,54,250,8,-101,62,-38,22752,1,13.9,18.4,2.4,0.4,-4.4,2.7,1
51678,121,69,-50,2711,21,52,-29,22,7528,-1,16.1,9.2,-6.7,2.8,6.9,-3.9,6
51680,1149,922,-44,10680,127,227,83,307,79535,-3,14.5,11.6,-0.6,1.6,2.9,1,2
51683,693,365,-697,67,394,328,-303,23,42696,-2,16.2,8.6,-16.3,9.2,7.7,-7.1,1
51685,70,85,-415,0,100,-15,-315,-332,16361,-2,4.2,5.1,-25.1,6.1,-0.9,-19.1,1
51690,260,298,61,488,43,-38,104,66,13763,0,18.9,21.7,4.4,3.1,-2.8,7.6,4
51700,2504,1768,-1977,8283,387,736,-1590,-862,183118,-8,13.6,9.6,-10.8,2.1,4,-8.7,1
51710,3102,2208,-3214,22087,727,894,-2487,-1628,230930,-35,13.4,9.5,-13.9,3.1,3.9,-10.7,1
51720,41,93,-44,28,0,-52,-44,-97,3492,-1,11.6,26.3,-12.4,0,-14.7,-12.4,7
51730,730,640,-286,528,47,90,-239,-153,33309,-4,21.9,19.2,-8.6,1.4,2.7,-7.2,1
51735,132,132,11,90,2,0,13,11,12635,-2,10.5,10.5,0.9,0.2,0,1,1
51740,1329,1229,-316,2784,63,100,-253,-161,96793,-8,13.7,12.7,-3.3,0.7,1,-2.6,1
51750,141,140,231,3466,20,1,251,252,16971,0,8.4,8.3,13.7,1.2,0.1,14.9,3
51760,2971,2241,-717,11631,910,730,193,880,229247,-43,13,9.8,-3.1,4,3.2,0.8,1
51770,1266,1433,-576,2057,271,-167,-305,-486,97171,-14,13,14.7,-5.9,2.8,-1.7,-3.1,2
51775,321,391,-88,2026,57,-70,-31,-100,25600,1,12.5,15.2,-3.4,2.2,-2.7,-1.2,2
51790,364,404,-53,1426,72,-40,19,-25,25915,-4,14,15.6,-2,2.8,-1.5,0.7,3
51800,1125,992,2013,1574,88,133,2101,2233,100659,-1,11.3,10,20.2,0.9,1.3,21.1,1
51810,5353,3635,-4026,7011,881,1718,-3145,-1420,453649,7,11.8,8,-8.9,1.9,3.8,-6.9,1
51820,356,312,325,274,13,44,338,383,23182,1,15.5,13.6,14.1,0.6,1.9,14.7,3
51830,63,222,273,4881,48,-159,321,162,15847,0,4,14.1,17.3,3,-10.1,20.4,1
51840,335,331,-310,1131,62,4,-248,-244,27617,0,12.1,11.9,-11.2,2.2,0.1,-8.9,3
53000,82523,67663,-15276,153031,28919,14860,13643,28403,7812880,-100,10.6,8.7,-2,3.7,1.9,1.7,
53001,349,160,-279,334,14,189,-265,-78,20820,-2,16.7,7.7,-13.4,0.7,9.1,-12.7,6
53003,221,309,97,231,5,-88,102,13,22549,-1,9.8,13.7,4.3,0.2,-3.9,4.5,3
53005,2477,1900,1435,1245,376,577,1811,2390,215219,2,11.6,8.9,6.7,1.8,2.7,8.5,2
53007,791,850,-72,1642,89,-59,17,-41,79997,1,9.9,10.6,-0.9,1.1,-0.7,0.2,3
53009,546,1243,573,1368,54,-697,627,-68,77616,2,7,16,7.4,0.7,-9,8.1,5
53011,5536,4500,2572,3506,766,1036,3338,4413,521150,39,10.7,8.7,5,1.5,2,6.4,1
53013,34,66,59,60,1,-32,60,27,4053,-1,8.4,16.3,14.6,0.2,-7.9,14.9,8
53015,1218,1412,937,937,55,-194,992,800,112864,2,10.8,12.6,8.3,0.5,-1.7,8.8,3
53017,508,377,360,565,83,131,443,575,44798,1,11.4,8.5,8.1,1.9,2.9,10,3
53019,63,124,85,85,6,-61,91,29,7497,-1,8.4,16.6,11.4,0.8,-8.2,12.2,8
53021,1441,551,-631,2787,188,890,-443,452,99034,5,14.6,5.6,-6.4,1.9,9,-4.5,2
53023,27,32,12,19,0,-5,12,6,2363,-1,11.4,13.6,5.1,0,-2.1,5.1,8
53025,1365,882,404,2162,203,483,607,1098,102678,8,13.4,8.6,4,2,4.7,5.9,5
53027,675,1152,696,2743,28,-477,724,249,77290,2,8.7,14.9,9,0.4,-6.2,9.4,4
53029,761,897,-347,1784,83,-136,-264,-415,86267,-15,8.8,10.4,-4,1,-1.6,-3.1,4
53031,162,436,396,509,23,-274,419,144,33714,-1,4.8,13,11.8,0.7,-8.1,12.5,6
53033,22890,15088,-20431,44400,18815,7802,-1616,6069,2271380,-117,10.1,6.7,-9,8.3,3.4,-0.7,1
53035,2809,2551,-716,9984,324,258,-392,-155,277658,-21,10.1,9.2,-2.6,1.2,0.9,-1.4,2
53037,397,394,375,291,9,3,384,386,45508,-1,8.8,8.7,8.3,0.2,0.1,8.5,4
53039,186,273,321,637,50,-87,371,286,23589,2,7.9,11.6,13.7,2.1,-3.7,15.8,9
53041,926,1126,962,723,34,-200,996,797,86154,1,10.8,13.1,11.2,0.4,-2.3,11.6,4
53043,98,145,170,67,2,-47,172,125,11738,0,8.4,12.4,14.6,0.2,-4,14.7,8
53045,619,826,266,2067,155,-207,421,218,68389,4,9.1,12.1,3.9,2.3,-3,6.2,4
53047,421,577,176,1312,230,-156,406,252,43712,2,9.7,13.2,4,5.3,-3.6,9.3,6
53049,150,407,334,311,29,-257,363,105,24200,-1,6.2,16.9,13.8,1.2,-10.6,15,7
53051,114,233,344,145,0,-119,344,223,14361,-2,8,16.4,24.1,0,-8.4,24.1,8
53053,10933,8162,-2396,21713,1846,2771,-550,2217,928696,-4,11.8,8.8,-2.6,2,3,-0.6,1
53055,103,151,-76,93,21,-48,-55,-106,18566,-3,5.5,8.1,-4.1,1.1,-2.6,-3,9
53057,1389,1446,23,1447,136,-57,159,95,131417,-7,10.6,11,0.2,1,-0.4,1.2,3
53059,88,103,198,454,2,-15,200,185,12640,0,7,8.2,15.8,0.2,-1.2,15.9,1
53061,9749,6475,-2282,8374,3349,3274,1067,4309,844761,-32,11.6,7.7,-2.7,4,3.9,1.3,1
53063,5710,5565,1033,16306,511,145,1544,1715,551455,26,10.4,10.1,1.9,0.9,0.3,2.8,2
53065,440,624,735,254,6,-184,741,554,48837,-3,9.1,12.9,15.1,0.1,-3.8,15.3,2
53067,3043,2943,-63,4325,337,100,274,364,299003,-10,10.2,9.8,-0.2,1.1,0.3,0.9,2
53069,31,68,116,10,0,-37,116,77,4765,-2,6.6,14.4,24.5,0,-7.8,24.5,8
53071,553,728,-197,4548,85,-175,-112,-285,61568,2,9,11.8,-3.2,1.4,-2.8,-1.8,3
53073,1969,2076,1034,5982,379,-107,1413,1321,231919,15,8.5,9,4.5,1.6,-0.5,6.1,3
53075,390,349,84,5555,309,41,393,433,48012,-1,8.2,7.3,1.8,6.5,0.9,8.2,4
53077,3341,2462,-1583,4056,316,879,-1267,-376,256643,12,13,9.6,-6.2,1.2,3.4,-4.9,2
54000,17263,25929,3595,52052,1101,-8666,4696,-3964,1770071,6,9.7,14.6,2,0.6,-4.9,2.7,
54001,137,250,97,714,3,-113,100,-13,15378,0,8.9,16.3,6.3,0.2,-7.3,6.5,9
54003,1518,1323,2820,939,47,195,2867,3061,132440,-1,11.6,10.1,21.5,0.4,1.5,21.9,2
54005,189,366,-158,148,1,-177,-157,-331,20576,3,9.1,17.6,-7.6,0,-8.5,-7.6,3
54007,102,194,84,436,0,-92,84,-8,12162,0,8.4,15.9,6.9,0,-7.6,6.9,8
54009,159,383,-108,698,14,-224,-94,-321,21373,-3,7.4,17.8,-5,0.7,-10.4,-4.4,3
54011,887,1350,24,4504,38,-463,62,-403,92082,-2,9.6,14.6,0.3,0.4,-5,0.7,2
54013,60,124,-43,23,-3,-64,-46,-110,5959,0,10,20.6,-7.1,-0.5,-10.6,-7.6,8
54015,96,153,-1,55,0,-57,-1,-57,7783,1,12.3,19.6,-0.1,0,-7.3,-0.1,3
54017,65,91,-4,1115,-2,-26,-6,-32,7680,0,8.4,11.8,-0.5,-0.3,-3.4,-0.8,9
54019,378,714,16,1487,4,-336,20,-316,39072,0,9.6,18.2,0.4,0.1,-8.6,0.5,3
54021,49,91,-38,1651,4,-42,-34,-76,7254,0,6.7,12.5,-5.2,0.5,-5.8,-4.7,9
54023,92,175,60,120,8,-83,68,-17,10921,-2,8.4,16,5.5,0.7,-7.6,6.2,9
54025,303,573,30,399,16,-270,46,-226,32149,-2,9.4,17.8,0.9,0.5,-8.4,1.4,6
54027,251,317,261,416,-3,-66,258,192,23649,0,10.7,13.5,11.1,-0.1,-2.8,11,3
54029,245,489,134,265,3,-244,137,-109,28145,-2,8.7,17.3,4.8,0.1,-8.7,4.9,3
54031,128,187,139,71,4,-59,143,83,14251,-1,9,13.2,9.8,0.3,-4.2,10.1,8
54033,672,943,138,917,19,-271,157,-113,64639,1,10.4,14.6,2.1,0.3,-4.2,2.4,5
54035,267,416,58,142,16,-149,74,-74,27593,1,9.7,15.1,2.1,0.6,-5.4,2.7,8
54037,538,551,712,1089,84,-13,796,786,59787,3,9.1,9.3,12,1.4,-0.2,13.4,1
54039,1726,2590,-422,3094,223,-864,-199,-1059,174805,4,9.8,14.8,-2.4,1.3,-4.9,-1.1,3
54041,154,319,-9,215,0,-165,-9,-174,16500,0,9.3,19.2,-0.5,0,-9.9,-0.5,9
54043,193,357,11,60,4,-164,15,-150,19701,-1,9.8,18.1,0.6,0.2,-8.3,0.8,8
54045,312,631,-59,755,-2,-319,-61,-379,30827,1,10.1,20.3,-1.9,-0.1,-10.3,-2,6
54047,160,390,-153,2014,15,-230,-138,-367,17439,1,9.1,22.1,-8.7,0.9,-13.1,-7.8,9
54049,526,756,255,1556,0,-230,255,23,55807,-2,9.4,13.5,4.6,0,-4.1,4.6,4
54051,263,465,-66,874,6,-202,-60,-262,29405,0,8.9,15.7,-2.2,0.2,-6.8,-2,3
54053,273,448,26,737,1,-175,27,-146,24765,2,11,18,1,0,-7,1.1,6
54055,615,1000,-190,1178,20,-385,-170,-555,58057,0,10.5,17.1,-3.3,0.3,-6.6,-2.9,4
54057,293,394,73,500,-7,-101,66,-35,26867,0,10.9,14.7,2.7,-0.3,-3.8,2.5,7
54059,259,448,-230,92,-3,-189,-233,-422,22023,0,11.6,20.1,-10.3,-0.1,-8.5,-10.5,8
54061,980,737,106,8166,389,243,495,740,107718,2,9.1,6.9,1,3.6,2.3,4.6,3
54063,133,217,138,258,6,-84,144,60,12382,0,10.8,17.6,11.2,0.5,-6.8,11.7,8
54065,150,265,334,185,-2,-115,332,214,17649,-3,8.6,15.1,19,-0.1,-6.6,18.9,2
54067,223,391,7,81,21,-168,28,-140,24169,0,9.2,16.1,0.3,0.9,-6.9,1.2,8
54069,382,637,-44,2149,29,-255,-15,-269,41194,1,9.2,15.4,-1.1,0.7,-6.2,-0.4,3
54071,63,106,3,93,2,-43,5,-38,6029,0,10.4,17.5,0.5,0.3,-7.1,0.8,8
54073,74,116,-100,742,0,-42,-100,-142,7428,0,9.9,15.5,-13.3,0,-5.6,-13.3,8
54075,64,134,38,290,0,-70,38,-32,7765,0,8.2,17.2,4.9,0,-9,4.9,9
54077,302,433,-20,3326,29,-131,9,-123,34099,-1,8.8,12.7,-0.6,0.8,-3.8,0.3,3
54079,537,664,-3,316,28,-127,25,-101,56962,1,9.4,11.6,-0.1,0.5,-2.2,0.4,2
54081,655,1197,65,3345,30,-542,95,-445,72356,2,9,16.5,0.9,0.4,-7.5,1.3,3
54083,265,441,-25,2428,0,-176,-25,-202,27350,-1,9.7,16.1,-0.9,0,-6.4,-0.9,7
54085,84,137,-12,32,2,-53,-10,-63,8167,0,10.2,16.7,-1.5,0.2,-6.5,-1.2,8
54087,125,220,4,90,1,-95,5,-90,13743,0,9.1,16,0.3,0.1,-6.9,0.4,8
54089,94,248,34,1002,-1,-154,33,-121,11581,0,8.1,21.3,2.9,-0.1,-13.2,2.8,8
54091,151,253,80,460,-1,-102,79,-22,16388,1,9.2,15.4,4.9,-0.1,-6.2,4.8,6
54093,60,114,39,129,0,-54,39,-16,6604,-1,9.1,17.2,5.9,0,-8.2,5.9,9
54095,76,139,-108,71,-1,-63,-109,-171,7919,1,9.5,17.4,-13.5,-0.1,-7.9,-13.6,9
54097,233,318,-95,982,3,-85,-92,-176,23529,1,9.9,13.5,-4,0.1,-3.6,-3.9,7
54099,363,624,-55,175,21,-261,-34,-294,37686,1,9.6,16.5,-1.5,0.6,-6.9,-0.9,2
54101,77,147,-26,61,0,-70,-26,-96,8045,0,9.5,18.2,-3.2,0,-8.6,-3.2,9
54103,149,293,33,109,9,-144,42,-104,13890,-2,10.7,21,2.4,0.6,-10.3,3,7
54105,56,85,-64,0,0,-29,-64,-92,5000,1,11.1,16.8,-12.7,0,-5.7,-12.7,3
54107,853,1152,-68,1132,29,-299,-39,-336,83052,2,10.2,13.8,-0.8,0.3,-3.6,-0.5,3
54109,204,373,-123,166,-3,-169,-126,-295,20277,0,10,18.3,-6,-0.1,-8.3,-6.2,8
55000,59839,58692,5648,137061,13653,1147,19301,20412,5910955,-36,10.1,9.9,1,2.3,0.2,3.3,
55001,122,316,384,1306,7,-194,391,197,21449,0,5.7,14.8,18,0.3,-9.1,18.3,8
55003,161,200,70,566,8,-39,78,39,16079,0,10,12.5,4.4,0.5,-2.4,4.9,7
55005,444,605,186,799,95,-161,281,118,46833,-2,9.5,12.9,4,2,-3.4,6,6
55007,115,190,184,52,2,-75,186,110,16769,-1,6.9,11.4,11,0.1,-4.5,11.1,8
55009,3004,2262,49,6448,546,742,595,1349,271417,12,11.1,8.4,0.2,2,2.7,2.2,2
55011,125,143,49,109,1,-18,50,29,13419,-3,9.3,10.7,3.7,0.1,-1.3,3.7,8
55013,94,227,228,165,7,-133,235,104,17092,2,5.5,13.3,13.4,0.4,-7.8,13.8,8
55015,457,399,390,169,43,58,433,487,53199,-4,8.6,7.5,7.4,0.8,1.1,8.2,3
55017,651,657,207,2639,15,-6,222,217,66970,1,9.7,9.8,3.1,0.2,-0.1,3.3,3
55019,566,387,-191,402,55,179,-136,42,34774,-1,16.3,11.1,-5.5,1.6,5.2,-3.9,8
55021,568,620,-121,1397,34,-52,-87,-137,58091,2,9.8,10.7,-2.1,0.6,-0.9,-1.5,2
55023,161,198,-38,675,5,-37,-33,-71,15944,-1,10.1,12.4,-2.4,0.3,-2.3,-2.1,6
55025,5580,3579,2092,17536,3456,2001,5548,7589,575347,40,9.8,6.3,3.7,6,3.5,9.7,2
55027,756,1064,48,5121,115,-308,163,-143,88231,2,8.6,12,0.5,1.3,-3.5,1.8,4
55029,212,379,142,309,36,-167,178,11,30562,0,6.9,12.4,4.6,1.2,-5.5,5.8,6
55031,414,501,81,1348,42,-87,123,38,44264,2,9.4,11.3,1.8,0.9,-2,2.8,2
55033,444,408,76,3015,60,36,136,172,45794,0,9.7,8.9,1.7,1.3,0.8,3,6
55035,1059,958,885,4767,123,101,1008,1117,107903,8,9.9,8.9,8.2,1.1,0.9,9.4,3
55037,29,66,13,41,0,-37,13,-24,4682,0,6.2,14.1,2.8,0,-7.9,2.8,9
55039,1005,1136,55,3258,212,-131,267,136,103948,0,9.7,10.9,0.5,2,-1.3,2.6,3
55041,88,152,54,118,3,-64,57,-7,9325,0,9.4,16.3,5.8,0.3,-6.9,6.1,9
55043,560,572,65,3317,40,-12,105,94,51409,1,10.9,11.1,1.3,0.8,-0.2,2,6
55045,351,397,84,342,30,-46,114,66,36951,-2,9.5,10.8,2.3,0.8,-1.2,3.1,2
55047,203,286,213,234,11,-83,224,136,19344,-5,10.5,14.8,11.1,0.6,-4.3,11.6,6
55049,258,211,-73,182,24,47,-49,-2,23956,0,10.8,8.8,-3,1,2,-2,2
55051,40,108,98,97,1,-68,99,29,6228,-2,6.4,17.4,15.8,0.2,-10.9,15.9,9
55053,213,237,-37,1227,22,-24,-15,-38,20855,1,10.2,11.4,-1.8,1.1,-1.1,-0.7,8
55055,789,858,-9,3899,94,-69,85,18,85743,2,9.2,10,-0.1,1.1,-0.8,1,4
55057,221,372,-45,1563,17,-151,-28,-181,26594,-2,8.3,13.9,-1.7,0.6,-5.7,-1,8
55059,1681,1627,-525,4026,313,54,-212,-149,167488,9,10,9.7,-3.1,1.9,0.3,-1.3,3
55061,197,205,28,189,18,-8,46,37,20690,-1,9.5,9.9,1.4,0.9,-0.4,2.2,2
55063,1113,1103,135,4846,86,10,221,234,120486,3,9.2,9.2,1.1,0.7,0.1,1.8,3
55065,248,166,-82,96,38,82,-44,39,16945,1,14.7,9.8,-4.8,2.2,4.8,-2.6,8
55067,175,306,25,264,9,-131,34,-98,19404,-1,9,15.7,1.3,0.5,-6.7,1.7,6
55069,253,436,211,422,21,-183,232,50,28405,1,8.9,15.4,7.4,0.7,-6.4,8.2,6
55071,726,917,184,1085,143,-191,327,133,81331,-3,8.9,11.3,2.3,1.8,-2.4,4,4
55073,1437,1366,338,1729,258,71,596,657,138612,-10,10.4,9.9,2.4,1.9,0.5,4.3,3
55075,359,597,352,686,26,-238,378,140,42106,0,8.5,14.2,8.4,0.6,-5.7,9,6
55077,127,250,175,155,11,-123,186,61,15838,-2,8,15.8,11.1,0.7,-7.8,11.8,8
55078,64,69,26,8,0,-5,26,20,4226,-1,15.2,16.4,6.2,0,-1.2,6.2,9
55079,11327,8928,-8408,19156,4154,2399,-4254,-1873,916205,-18,12.4,9.7,-9.2,4.5,2.6,-4.6,1
55081,575,537,178,691,45,38,223,257,46151,-4,12.5,11.7,3.9,1,0.8,4.8,4
55083,333,416,155,378,5,-83,160,79,39775,2,8.4,10.5,3.9,0.1,-2.1,4,2
55085,265,521,274,512,12,-256,286,33,38226,3,6.9,13.6,7.2,0.3,-6.7,7.5,7
55087,2109,1593,126,3353,320,516,446,965,193234,3,10.9,8.3,0.7,1.7,2.7,2.3,3
55089,814,883,340,2055,178,-69,518,439,93460,-10,8.7,9.5,3.6,1.9,-0.7,5.6,1
55091,76,82,58,10,12,-6,70,63,7441,-1,10.3,11.1,7.8,1.6,-0.8,9.4,8
55093,395,366,408,2390,37,29,445,474,43026,0,9.2,8.6,9.5,0.9,0.7,10.4,1
55095,401,567,373,508,12,-166,385,216,45762,-3,8.8,12.4,8.2,0.3,-3.6,8.4,8
55097,599,696,292,2972,198,-97,490,390,71024,-3,8.5,9.8,4.1,2.8,-1.4,6.9,4
55099,93,210,48,154,12,-117,60,-57,14102,0,6.6,14.9,3.4,0.8,-8.3,4.2,9
55101,2132,2127,250,3825,396,5,646,652,196613,1,10.9,10.8,1.3,2,0,3.3,3
55103,175,231,108,372,17,-56,125,69,17197,0,10.2,13.5,6.3,1,-3.3,7.3,8
55105,1765,1703,241,2716,134,62,375,437,164278,0,10.8,10.4,1.5,0.8,0.4,2.3,3
55107,120,237,152,145,9,-117,161,44,14143,0,8.5,16.8,10.8,0.6,-8.3,11.4,8
55109,1019,787,522,811,48,232,570,796,96763,-6,10.6,8.2,5.4,0.5,2.4,5.9,1
55111,701,733,0,956,183,-32,183,150,65920,-1,10.6,11.1,0,2.8,-0.5,2.8,4
55113,136,275,161,305,7,-139,168,31,18552,2,7.3,14.8,8.7,0.4,-7.5,9.1,9
55115,431,495,171,461,16,-64,187,122,41109,-1,10.5,12.1,4.2,0.4,-1.6,4.6,6
55117,1111,1218,-94,2949,293,-107,199,91,117752,-1,9.4,10.3,-0.8,2.5,-0.9,1.7,3
55119,216,221,103,109,18,-5,121,117,20058,1,10.8,11.1,5.2,0.9,-0.3,6.1,8
55121,382,304,-130,399,58,78,-72,8,30899,2,12.4,9.8,-4.2,1.9,2.5,-2.3,8
55123,408,357,33,341,23,51,56,107,31170,0,13.1,11.5,1.1,0.7,1.6,1.8,3
55125,160,358,341,83,-1,-198,340,143,23885,1,6.7,15,14.3,0,-8.3,14.3,9
55127,913,1054,190,2853,109,-141,299,158,105822,0,8.6,10,1.8,1,-1.3,2.8,4
55129,124,277,209,172,4,-153,213,59,16930,-1,7.3,16.4,12.4,0.2,-9.1,12.6,8
55131,1264,1325,410,745,73,-61,483,412,138168,-10,9.2,9.6,3,0.5,-0.4,3.5,1
55133,3717,3936,1785,3272,783,-219,2568,2318,412591,-31,9,9.6,4.3,1.9,-0.5,6.2,1
55135,462,739,148,1256,10,-277,158,-122,51388,-3,9,14.4,2.9,0.2,-5.4,3.1,6
55137,180,329,148,1144,9,-149,157,7,24934,-1,7.2,13.2,5.9,0.4,-6,6.3,8
55139,1673,1649,659,6329,362,24,1021,1047,171735,2,9.8,9.6,3.8,2.1,0.1,6,3
55141,693,1008,391,1032,90,-315,481,161,73939,-5,9.4,13.6,5.3,1.2,-4.3,6.5,4
56000,5882,5779,2016,13910,322,103,2338,2428,584057,-13,10.1,9.9,3.5,0.6,0.2,4,
56001,307,237,-220,2976,231,70,11,79,38257,-2,8,6.2,-5.8,6,1.8,0.3,4
56003,132,155,157,261,4,-23,161,139,12018,1,11,13,13.1,0.3,-1.9,13.5,9
56005,567,335,205,587,1,232,206,439,47498,1,12,7.1,4.3,0,4.9,4.4,5
56007,144,154,-209,589,16,-10,-193,-204,14334,-1,10,10.7,-14.5,1.1,-0.7,-13.4,7
56009,127,145,62,84,1,-18,63,44,13809,-1,9.2,10.5,4.5,0.1,-1.3,4.6,6
56011,87,84,174,29,-3,3,171,173,7592,-1,11.6,11.2,23.2,-0.4,0.4,22.8,9
56013,442,514,319,1403,4,-72,323,249,39815,-2,11.1,13,8,0.1,-1.8,8.1,7
56015,110,176,71,1126,2,-66,73,6,12642,-1,8.7,13.9,5.6,0.2,-5.2,5.8,7
56017,34,84,89,97,0,-50,89,38,4661,-1,7.3,18.1,19.2,0,-10.8,19.2,9
56019,76,102,75,145,-8,-26,67,40,8759,-1,8.7,11.7,8.6,-0.9,-3,7.7,9
56021,1121,1054,121,1619,15,67,136,203,100984,0,11.1,10.4,1.2,0.1,0.7,1.3,3
56023,209,152,154,69,-1,57,153,209,20880,-1,10.1,7.3,7.4,0,2.7,7.4,9
56025,827,792,381,1266,0,35,381,418,79941,2,10.4,9.9,4.8,0,0.4,4.8,3
56027,21,33,19,244,0,-12,19,6,2354,-1,8.9,14,8.1,0,-5.1,8.1,9
56029,266,352,312,669,7,-86,319,230,30735,-3,8.7,11.5,10.2,0.2,-2.8,10.4,7
56031,70,145,-45,93,15,-75,-30,-106,8546,-1,8.1,16.9,-5.2,1.7,-8.7,-3.5,8
56033,296,353,533,778,9,-57,542,484,32519,-1,9.2,10.9,16.5,0.3,-1.8,16.8,7
56035,75,73,220,55,-3,2,217,217,8969,-2,8.5,8.2,24.8,-0.3,0.2,24.5,9
56037,430,366,-180,629,-12,64,-192,-125,41249,3,10.4,8.9,-4.4,-0.3,1.5,-4.6,5
56039,190,90,-221,280,55,100,-166,-65,23232,1,8.2,3.9,-9.5,2.4,4.3,-7.1,7
56041,229,182,-23,218,-6,47,-29,18,20745,0,11,8.8,-1.1,-0.3,2.3,-1.4,7
56043,72,109,25,144,-1,-37,24,-14,7710,-1,9.3,14.1,3.2,-0.1,-4.8,3.1,9
56045,50,92,-3,549,-4,-42,-7,-50,6808,-1,7.3,13.5,-0.4,-0.6,-6.1,-1,9
6000,414120,302704,-338371,891995,150982,111416,-187389,-75423,38965193,550,10.6,7.8,-8.7,3.9,2.9,-4.8,
6001,16418,10571,-24633,50861,12740,5847,-11893,-6071,1622188,-25,10.1,6.5,-15.2,7.8,3.6,-7.3,1
6003,7,22,-33,53,1,-15,-32,-49,1141,-2,6,18.9,-28.3,0.9,-12.9,-27.5,8
6005,331,553,517,4202,25,-222,542,318,41811,-2,7.9,13.3,12.4,0.6,-5.3,13,6
6007,1947,2388,12,4566,238,-441,250,-197,207172,-6,9.4,11.5,0.1,1.1,-2.1,1.2,3
6009,376,594,214,399,15,-218,229,9,46565,-2,8.1,12.8,4.6,0.3,-4.7,4.9,6
6011,283,188,2,160,31,95,33,128,22037,0,12.9,8.6,0.1,1.4,4.3,1.5,6
6013,11573,8599,-10314,11066,5258,2974,-5056,-1994,1155025,88,10,7.4,-8.9,4.5,2.6,-4.4,1
6015,236,359,-404,1981,2,-123,-402,-523,26589,2,8.8,13.4,-15,0.1,-4.6,-15,7
6017,1495,1748,-530,1216,216,-253,-314,-572,192215,-5,7.8,9.1,-2.8,1.1,-1.3,-1.6,1
6019,13879,8384,-6015,18565,2261,5495,-3754,1803,1017162,62,13.7,8.2,-5.9,2.2,5.4,-3.7,1
6021,354,327,-287,162,28,27,-259,-231,28129,1,12.5,11.6,-10.2,1,1,-9.2,6
6023,1225,1566,-744,4411,131,-341,-613,-959,133985,-5,9.1,11.6,-5.5,1,-2.5,-4.6,5
6025,2424,1403,-1410,7571,493,1021,-917,117,179057,13,13.5,7.8,-7.9,2.8,5.7,-5.1,3
6027,161,222,-154,553,1,-61,-153,-215,18527,-1,8.6,11.9,-8.3,0.1,-3.3,-8.2,6
6029,12077,7622,-9169,20400,1659,4455,-7510,-2931,913820,124,13.2,8.3,-10,1.8,4.9,-8.2,2
6031,2084,1116,-1465,15626,188,968,-1277,-305,152682,4,13.6,7.3,-9.6,1.2,6.3,-8.4,3
6033,683,972,-61,601,57,-289,-4,-294,67878,-1,10,14.3,-0.9,0.8,-4.2,-0.1,4
6035,264,287,-1179,5483,36,-23,-1143,-1159,28861,7,9,9.7,-40,1.2,-0.8,-38.8,7
6037,95354,73138,-119037,207185,40388,22216,-78649,-56420,9663345,13,9.8,7.5,-12.3,4.2,2.3,-8.1,1
6039,2078,1419,1744,6865,119,659,1863,2529,162858,7,12.9,8.8,10.8,0.7,4.1,11.5,1
6041,2255,2088,-2953,7595,1038,167,-1915,-1747,254407,1,8.8,8.2,-11.6,4.1,0.7,-7.5,1
6043,145,225,-106,190,54,-80,-52,-134,16919,-2,8.5,13.2,-6.2,3.2,-4.7,-3.1,8
6045,856,1013,-871,1432,129,-157,-742,-899,89108,0,9.6,11.3,-9.7,1.4,-1.8,-8.3,4
6047,3787,2169,-593,5806,660,1618,67,1710,291920,25,13,7.5,-2,2.3,5.6,0.2,2
6049,34,115,-50,164,13,-81,-37,-119,8500,-1,4,13.4,-5.8,1.5,-9.5,-4.3,8
6051,114,61,-78,292,90,53,12,64,13066,-1,8.7,4.7,-6,6.9,4.1,0.9,7
6053,5548,2857,-6190,16757,1340,2691,-4850,-2161,430723,-2,12.8,6.6,-14.3,3.1,6.2,-11.2,2
6055,1167,1262,-1339,4969,279,-95,-1060,-1154,133216,1,8.7,9.4,-10,2.1,-0.7,-7.9,3
6057,741,1110,-39,1891,50,-369,11,-364,102037,-6,7.2,10.9,-0.4,0.5,-3.6,0.1,4
6059,30677,22619,-35597,52887,12859,8058,-22738,-14617,3135755,63,9.8,7.2,-11.3,4.1,2.6,-7.2,1
6061,3607,3803,4920,4485,790,-196,5710,5487,423561,-27,8.6,9,11.7,1.9,-0.5,13.6,1
6063,145,216,-257,66,19,-71,-238,-312,19131,-3,7.5,11.2,-13.3,1,-3.7,-12.3,9
6065,27497,20536,7807,36120,3378,6961,11185,18201,2492442,55,11.1,8.3,3.1,1.4,2.8,4.5,1
6067,17698,13202,-12390,33390,7784,4496,-4606,-92,1584288,18,11.2,8.3,-7.8,4.9,2.8,-2.9,1
6069,850,462,126,445,17,388,143,532,68175,1,12.5,6.8,1.9,0.3,5.7,2.1,1
6071,26188,17486,-11384,40501,3211,8702,-8173,703,2195611,174,11.9,8,-5.2,1.5,4,-3.7,1
6073,37145,24263,-30745,112078,10767,12882,-19978,-7203,3269973,-107,11.3,7.4,-9.4,3.3,3.9,-6.1,1
6075,7240,6200,-5925,26584,6201,1040,276,1214,808988,-102,9,7.7,-7.3,7.7,1.3,0.3,1
6077,9570,6313,386,14988,2983,3257,3369,6672,800965,46,12,7.9,0.5,3.7,4.1,4.2,2
6079,2389,2563,-568,15695,332,-174,-236,-407,281639,3,8.5,9.1,-2,1.2,-0.6,-0.8,2
6081,7394,4872,-10335,9331,5269,2522,-5066,-2576,726353,-32,10.2,6.7,-14.2,7.2,3.5,-7,1
6083,5560,3423,-6246,20051,1424,2137,-4822,-2658,441257,27,12.6,7.7,-14.1,3.2,4.8,-10.9,2
6085,18707,10741,-29077,46758,20405,7966,-8672,-743,1877592,-37,10,5.7,-15.5,10.9,4.2,-4.6,1
6087,2261,1903,-3455,14292,396,358,-3059,-2693,261547,8,8.6,7.2,-13.1,1.5,1.4,-11.6,2
6089,1734,2543,-15,2831,254,-809,239,-571,180366,-1,9.6,14.1,-0.1,1.4,-4.5,1.3,3
6091,23,34,-11,29,0,-11,-11,-22,3200,0,7.2,10.6,-3.4,0,-3.4,-3.4,8
6093,323,644,-579,483,22,-321,-557,-881,42905,-3,7.5,14.9,-13.4,0.5,-7.4,-12.9,7
6095,4792,3819,-1965,9751,1312,973,-653,333,449218,13,10.7,8.5,-4.4,2.9,2.2,-1.5,2
6097,4480,4388,-1765,8311,813,92,-952,-857,481812,3,9.3,9.1,-3.7,1.7,0.2,-2,2
6099,7077,5013,-3144,6478,1229,2064,-1915,204,551430,55,12.8,9.1,-5.7,2.2,3.7,-3.5,2
6101,1181,945,-1167,931,307,236,-860,-621,97948,3,12,9.6,-11.9,3.1,2.4,-8.8,3
6103,745,870,-274,764,-7,-125,-281,-403,64896,3,11.4,13.4,-4.2,-0.1,-1.9,-4.3,4
6105,100,188,-14,215,-5,-88,-19,-108,15670,-1,6.4,12,-0.9,-0.3,-5.6,-1.2,8
6107,6746,3712,-2119,4829,616,3034,-1503,1584,479468,53,14.1,7.8,-4.4,1.3,6.3,-3.1,2
6109,437,791,-50,3186,23,-354,-27,-383,54204,-2,8,14.5,-0.9,0.4,-6.5,-0.5,4
6111,8581,6524,-6754,11360,1390,2057,-5364,-3281,829590,26,10.3,7.8,-8.1,1.7,2.5,-6.5,2
6113,1900,1507,-3414,11795,1523,393,-1891,-1474,220544,24,8.6,6.8,-15.4,6.9,1.8,-8.5,1
6115,1177,746,805,2339,130,431,935,1369,85722,3,13.8,8.8,9.5,1.5,5.1,11,3
72000,,,,,,,,,3205691,,,,,,,,
72001,,,,,,,,,17900,,,,,,,,6
72003,,,,,,,,,37528,,,,,,,,2
72005,,,,,,,,,53622,,,,,,,,2
72007,,,,,,,,,23274,,,,,,,,1
72009,,,,,,,,,24602,,,,,,,,1
72011,,,,,,,,,24815,,,,,,,,2
72013,,,,,,,,,85641,,,,,,,,3
72015,,,,,,,,,15078,,,,,,,,3
72017,,,,,,,,,22376,,,,,,,,1
72019,,,,,,,,,29020,,,,,,,,1
72021,,,,,,,,,180835,,,,,,,,1
72023,,,,,,,,,46665,,,,,,,,3
72025,,,,,,,,,124608,,,,,,,,1
72027,,,,,,,,,32625,,,,,,,,3
72029,,,,,,,,,41513,,,,,,,,1
72031,,,,,,,,,150843,,,,,,,,1
72033,,,,,,,,,22108,,,,,,,,1
72035,,,,,,,,,40525,,,,,,,,1
72037,,,,,,,,,10843,,,,,,,,1
72039,,,,,,,,,16691,,,,,,,,1
72041,,,,,,,,,39418,,,,,,,,1
72043,,,,,,,,,33662,,,,,,,,4
72045,,,,,,,,,18601,,,,,,,,1
72047,,,,,,,,,34348,,,,,,,,1
72049,,,,,,,,,1761,,,,,,,,9
72051,,,,,,,,,35702,,,,,,,,1
72053,,,,,,,,,31166,,,,,,,,1
72054,,,,,,,,,11525,,,,,,,,1
72055,,,,,,,,,12415,,,,,,,,6
72057,,,,,,,,,34765,,,,,,,,3
72059,,,,,,,,,16813,,,,,,,,2
72061,,,,,,,,,89039,,,,,,,,1
72063,,,,,,,,,39971,,,,,,,,1
72065,,,,,,,,,37950,,,,,,,,3
72067,,,,,,,,,15336,,,,,,,,3
72069,,,,,,,,,49712,,,,,,,,1
72071,,,,,,,,,42794,,,,,,,,2
72073,,,,,,,,,14435,,,,,,,,6
72075,,,,,,,,,45919,,,,,,,,2
72077,,,,,,,,,36684,,,,,,,,1
72079,,,,,,,,,22872,,,,,,,,3
72081,,,,,,,,,27729,,,,,,,,4
72083,,,,,,,,,8672,,,,,,,,8
72085,,,,,,,,,34750,,,,,,,,1
72087,,,,,,,,,22302,,,,,,,,1
72089,,,,,,,,,17386,,,,,,,,1
72091,,,,,,,,,38655,,,,,,,,1
72093,,,,,,,,,4523,,,,,,,,8
72095,,,,,,,,,10266,,,,,,,,1
72097,,,,,,,,,69798,,,,,,,,3
72099,,,,,,,,,37325,,,,,,,,2
72101,,,,,,,,,28197,,,,,,,,1
72103,,,,,,,,,22838,,,,,,,,1
72105,,,,,,,,,29282,,,,,,,,1
72107,,,,,,,,,21204,,,,,,,,1
72109,,,,,,,,,15347,,,,,,,,3
72111,,,,,,,,,19563,,,,,,,,2
72113,,,,,,,,,130251,,,,,,,,2
72115,,,,,,,,,23254,,,,,,,,3
72117,,,,,,,,,15425,,,,,,,,2
72119,,,,,,,,,45568,,,,,,,,1
72121,,,,,,,,,22210,,,,,,,,3
72123,,,,,,,,,24718,,,,,,,,4
72125,,,,,,,,,30996,,,,,,,,3
72127,,,,,,,,,333005,,,,,,,,1
72129,,,,,,,,,37264,,,,,,,,1
72131,,,,,,,,,38926,,,,,,,,2
72133,,,,,,,,,19693,,,,,,,,6
72135,,,,,,,,,65957,,,,,,,,1
72137,,,,,,,,,71888,,,,,,,,1
72139,,,,,,,,,66705,,,,,,,,1
72141,,,,,,,,,27242,,,,,,,,6
72143,,,,,,,,,34638,,,,,,,,1
72145,,,,,,,,,53527,,,,,,,,1
72147,,,,,,,,,7999,,,,,,,,6
72149,,,,,,,,,21285,,,,,,,,2
72151,,,,,,,,,28897,,,,,,,,1
72153,,,,,,,,,32406,,,,,,,,2
8000,62498,45099,7236,125069,11931,17399,19167,36571,5877610,5,10.7,7.7,1.2,2,3,3.3,
8001,6534,3680,1717,4519,1241,2854,2958,5856,533365,44,12.3,6.9,3.2,2.3,5.4,5.6,1
8003,191,183,35,957,24,8,59,68,16655,1,11.5,11,2.1,1.4,0.5,3.5,7
8005,7639,4633,-6254,5476,3029,3006,-3225,-208,656061,11,11.6,7.1,-9.5,4.6,4.6,-4.9,1
8007,104,146,236,97,7,-42,243,200,14189,-1,7.4,10.4,16.8,0.5,-3,17.2,7
8009,30,75,-52,44,7,-45,-45,-91,3344,-1,8.9,22.1,-15.3,2.1,-13.3,-13.3,9
8011,39,73,273,1500,0,-34,273,242,5681,3,7,13.1,49.1,0,-6.1,49.1,9
8013,2486,2038,-1919,15232,960,448,-959,-508,326831,3,7.6,6.2,-5.9,2.9,1.4,-2.9,2
8014,643,461,341,477,142,182,483,665,76860,0,8.4,6,4.5,1.9,2.4,6.3,1
8015,150,184,379,1239,5,-34,384,352,20617,2,7.3,9,18.5,0.2,-1.7,18.8,6
8017,14,26,-3,21,10,-12,7,-4,1727,1,8.1,15,-1.7,5.8,-6.9,4,9
8019,54,69,-206,83,2,-15,-204,-220,9147,-1,5.8,7.5,-22.3,0.2,-1.6,-22,1
8021,99,107,-56,57,-1,-8,-57,-66,7521,-1,13.1,14.2,-7.4,-0.1,-1.1,-7.5,9
8023,33,60,39,13,0,-27,39,13,3628,1,9.1,16.6,10.8,0,-7.5,10.8,9
8025,29,67,48,2612,-1,-38,47,9,5636,0,5.1,11.9,8.5,-0.2,-6.7,8.3,8
8027,41,61,215,4,2,-20,217,197,5534,0,7.5,11.2,39.6,0.4,-3.7,39.9,8
8029,273,475,378,240,11,-202,389,186,31746,-1,8.6,15,11.9,0.3,-6.4,12.3,6
8031,8632,4981,-2599,15890,2150,3651,-449,3124,716577,-78,12.1,7,-3.6,3,5.1,-0.6,1
8033,19,35,69,260,0,-16,69,53,2513,0,7.6,14.1,27.7,0,-6.4,27.7,9
8035,3812,1954,5465,1660,660,1858,6125,7969,383906,-14,10,5.1,14.4,1.7,4.9,16.1,1
8037,515,185,-1242,100,75,330,-1167,-837,54381,0,9.4,3.4,-22.7,1.4,6,-21.3,5
8039,263,219,924,65,2,44,926,964,28806,-6,9.3,7.7,32.6,0.1,1.6,32.7,1
8041,9147,5702,-619,19524,777,3445,158,3619,744215,16,12.3,7.7,-0.8,1,4.6,0.2,2
8043,351,676,1014,8740,6,-325,1020,702,50318,7,7,13.5,20.3,0.1,-6.5,20.4,4
8045,714,412,-6,1037,155,302,149,451,62707,0,11.4,6.6,-0.1,2.5,4.8,2.4,5
8047,48,41,5,42,28,7,33,40,5926,0,8.1,6.9,0.8,4.7,1.2,5.6,1
8049,121,103,152,213,29,18,181,201,15935,2,7.6,6.5,9.6,1.8,1.1,11.4,9
8051,134,85,-53,1037,6,49,-47,1,17321,-1,7.7,4.9,-3.1,0.3,2.8,-2.7,7
8053,4,5,-5,0,0,-1,-5,-6,765,0,5.2,6.5,-6.5,0,-1.3,-6.5,9
8055,40,135,53,120,-1,-95,52,-42,7055,1,5.7,19.1,7.5,-0.1,-13.4,7.3,8
8057,6,13,2,1,0,-7,2,-5,1309,0,4.6,9.9,1.5,0,-5.3,1.5,9
8059,5493,4997,-584,9341,662,496,78,555,576366,-19,9.5,8.7,-1,1.1,0.9,0.1,1
8061,20,21,-50,31,1,-1,-49,-50,1384,0,14.2,14.9,-35.5,0.7,-0.7,-34.8,9
8063,93,95,-17,91,31,-2,14,11,6994,-1,13.3,13.6,-2.4,4.4,-0.3,2,9
8065,85,46,-31,120,12,39,-19,19,7365,-1,11.6,6.3,-4.2,1.6,5.3,-2.6,9
8067,414,455,-134,1884,29,-41,-105,-146,56407,0,7.3,8.1,-2.4,0.5,-0.7,-1.9,6
8069,3094,2638,2249,12321,471,456,2720,3194,370771,18,8.4,7.1,6.1,1.3,1.2,7.4,2
8071,111,243,147,486,19,-132,166,37,14348,3,7.7,17,10.3,1.3,-9.2,11.6,7
8073,52,69,-18,860,4,-17,-14,-30,5480,1,9.5,12.6,-3.3,0.7,-3.1,-2.5,8
8075,192,270,-121,2709,26,-78,-95,-173,20619,0,9.3,13,-5.8,1.3,-3.8,-4.6,6
8077,1454,1780,1405,4128,68,-326,1473,1150,159681,3,9.1,11.2,8.8,0.4,-2,9.3,3
8079,7,11,19,0,0,-4,19,13,944,-2,7.5,11.7,20.3,0,-4.3,20.3,9
8081,135,113,105,116,-3,22,102,122,13327,-2,10.2,8.5,7.9,-0.2,1.7,7.7,7
8083,240,357,124,262,57,-117,181,64,26531,0,9.1,13.5,4.7,2.2,-4.4,6.8,6
8085,395,542,424,684,72,-147,496,349,44156,0,9,12.3,9.6,1.6,-3.3,11.3,5
8087,407,303,-64,408,218,104,154,258,29524,0,13.8,10.3,-2.2,7.4,3.5,5.2,6
8089,203,279,-98,307,-2,-76,-100,-175,18136,1,11.1,15.3,-5.4,-0.1,-4.2,-5.5,6
8091,32,40,71,0,10,-8,81,73,5176,0,6.2,7.8,13.8,1.9,-1.6,15.8,9
8093,138,132,177,25,11,6,188,196,18117,2,7.7,7.3,9.8,0.6,0.3,10.4,1
8095,51,70,13,60,36,-19,49,28,4476,-2,11.4,15.7,2.9,8.1,-4.3,11,9
8097,130,68,-299,49,29,62,-270,-207,16640,1,7.8,4.1,-17.9,1.7,3.7,-16.1,7
8099,142,135,-151,336,22,7,-129,-122,11751,0,12,11.4,-12.8,1.9,0.6,-10.9,7
8101,1646,2232,485,3535,47,-586,532,-50,169422,4,9.7,13.2,2.9,0.3,-3.5,3.1,3
8103,58,70,27,210,7,-12,34,20,6569,-2,8.8,10.7,4.1,1.1,-1.8,5.2,9
8105,121,168,-97,128,-2,-47,-99,-149,11188,-3,10.7,14.9,-8.6,-0.2,-4.2,-8.8,9
8107,206,137,-103,359,26,69,-77,-8,25064,0,8.2,5.5,-4.1,1,2.8,-3.1,7
8109,61,76,73,13,2,-15,75,61,6688,1,9.2,11.4,11,0.3,-2.3,11.3,9
8111,6,7,-4,0,0,-1,-4,-4,802,1,7.5,8.7,-5,0,-1.2,-5,9
8113,48,35,-169,5,15,13,-154,-140,7868,1,6,4.4,-21.3,1.9,1.6,-19.4,9
8115,14,40,40,27,0,-26,40,13,2299,-1,6.1,17.4,17.4,0,-11.3,17.4,9
8117,262,89,-423,579,84,173,-339,-171,30465,-5,8.6,2.9,-13.8,2.7,5.7,-11.1,5
8119,179,243,-184,115,9,-64,-175,-243,24617,-4,7.2,9.8,-7.4,0.4,-2.6,-7.1,2
8121,52,66,15,169,7,-14,22,8,4855,0,10.7,13.6,3.1,1.4,-2.9,4.5,9
8123,4658,2286,6254,4304,527,2372,6781,9176,359442,23,13.1,6.4,17.6,1.5,6.7,19.1,2
8125,134,102,-176,147,111,32,-65,-33,9862,0,13.6,10.3,-17.8,11.2,3.2,-6.6,9
9000,34957,32842,-9016,103382,15264,2115,6248,8470,3617176,107,9.7,9.1,-2.5,4.2,0.6,1.7,
9110,9391,9135,-1356,33794,4344,256,2988,3260,975328,16,9.6,9.4,-1.4,4.5,0.3,3.1,1
9120,3374,2400,-2558,10471,2075,974,-483,526,327651,35,10.3,7.3,-7.8,6.3,3,-1.5,2
9130,1432,1723,162,6535,368,-291,530,233,176215,-6,8.1,9.8,0.9,2.1,-1.7,3,1
9140,4388,4215,1016,6855,1370,173,2386,2538,456128,-21,9.6,9.3,2.2,3,0.4,5.2,2
9150,827,1015,631,1732,97,-188,728,544,96692,4,8.6,10.5,6.5,1,-1.9,7.6,4
9160,921,1192,249,2365,214,-271,463,186,113463,-6,8.1,10.5,2.2,1.9,-2.4,4.1,4
9170,5674,5462,-2722,22486,2246,212,-476,-244,568158,20,10,9.6,-4.8,4,0.4,-0.8,2
9180,2595,2962,157,11350,583,-367,740,377,279634,4,9.3,10.6,0.6,2.1,-1.3,2.6,2
9190,6355,4738,-4595,7794,3967,1617,-628,1050,623907,61,10.2,7.6,-7.4,6.4,2.6,-1,2
