fips_code,Civilian_labor_force_2023,Employed_2023,Metro_2023,Rural_Urban_Continuum_Code_2023,Unemployed_2023,Unemployment_rate_2023
0,166689556,160623678,,,6065878,3.6
1000,2308131,2250472,,,57659,2.5
10000,506529,486404,,,20125,4
10001,81412,77738,1,3,3674,4.5
10003,310311,298270,1,1,12041,3.9
10005,114807,110397,0,4,4410,3.8
1001,27000,26409,1,2,591,2.2
1003,104409,102029,1,3,2380,2.3
1005,7944,7592,0,6,352,4.4
1007,8772,8556,1,1,216,2.5
1009,25836,25282,1,1,554,2.1
1011,4500,4393,0,8,107,2.4
1013,9009,8746,0,6,263,2.9
1015,45540,44256,1,3,1284,2.8
1017,16272,15884,0,6,388,2.4
1019,11854,11570,0,8,284,2.4
1021,20293,19848,1,1,445,2.2
1023,4221,4052,0,9,169,4
1025,7591,7212,0,9,379,5
1027,5945,5805,0,9,140,2.4
1029,6205,6064,0,8,141,2.3
1031,21781,21235,0,4,546,2.5
1033,24063,23355,1,3,708,2.9
1035,4259,4108,0,9,151,3.5
1037,4549,4433,0,8,116,2.6
1039,14872,14464,0,6,408,2.7
1041,6160,5996,0,8,164,2.7
1043,39773,38961,0,4,812,2
1045,21198,20661,0,4,537,2.5
1047,13537,12803,0,4,734,5.4
1049,31004,30300,0,6,704,2.3
1051,38594,37772,1,2,822,2.1
1053,14440,13990,0,6,450,3.1
1055,39430,38328,1,3,1102,2.8
1057,6582,6392,0,8,190,2.9
1059,14247,13881,0,6,366,2.6
1061,11216,10942,1,3,274,2.4
1063,2851,2715,1,2,136,4.8
1065,5978,5779,1,2,199,3.3
1067,7059,6873,1,3,186,2.6
1069,48357,47108,1,3,1249,2.6
1071,23482,22899,0,6,583,2.5
1073,325388,317407,1,1,7981,2.5
1075,5759,5598,0,8,161,2.8
1077,43281,42182,1,3,1099,2.5
1079,14920,14583,1,3,337,2.3
1081,81236,79373,1,3,1863,2.3
1083,49912,48881,1,2,1031,2.1
1085,3501,3341,1,2,160,4.6
1087,7995,7740,1,3,255,3.2
1089,206080,201862,1,2,4218,2
1091,7585,7332,0,6,253,3.3
1093,13526,13131,0,9,395,2.9
1095,46210,45260,0,4,950,2.1
1097,190167,184271,1,2,5896,3.1
1099,6989,6690,0,8,299,4.3
11000,398251,378714,,,19537,4.9
11001,398251,378714,1,1,19537,4.9
1101,108083,105043,1,2,3040,2.8
1103,61853,60624,1,3,1229,2
1105,2979,2830,0,8,149,5
1107,7810,7574,1,2,236,3
1109,16124,15684,0,6,440,2.7
1111,9637,9401,0,8,236,2.4
1113,23550,22901,1,2,649,2.8
1115,42456,41549,1,1,907,2.1
1117,122282,120026,1,1,2256,1.8
1119,4584,4415,0,8,169,3.7
1121,36727,35708,0,4,1019,2.8
1123,17385,16947,0,6,438,2.5
1125,106199,103714,1,2,2485,2.3
1127,25677,24998,1,1,679,2.6
1129,9150,8915,0,8,235,2.6
1131,2526,2324,0,9,202,8
1133,9748,9482,0,8,266,2.7
12000,10988566,10668886,,,319680,2.9
12001,143954,139514,1,2,4440,3.1
12003,12862,12485,1,1,377,2.9
12005,89303,86818,1,3,2485,2.8
12007,10952,10611,0,6,341,3.1
12009,305643,296517,1,2,9126,3
12011,1085562,1054288,1,1,31274,2.9
12013,5011,4845,0,8,166,3.3
12015,78551,75829,1,3,2722,3.5
12017,49980,47735,1,3,2245,4.5
12019,115044,111715,1,1,3329,2.9
12021,192874,187334,1,2,5540,2.9
12023,29934,28921,0,4,1013,3.4
12027,13296,12820,0,6,476,3.6
12029,6003,5785,0,8,218,3.6
12031,520131,503763,1,1,16368,3.1
12033,153383,148668,1,2,4715,3.1
12035,51503,49590,1,2,1913,3.7
12037,4807,4669,0,8,138,2.9
12039,18662,17940,1,2,722,3.9
12041,7472,7228,1,2,244,3.3
12043,5185,4990,0,8,195,3.8
12045,5485,5338,0,8,147,2.7
12047,4238,4055,0,8,183,4.3
12049,9084,8709,0,6,375,4.1
12051,15886,15124,0,4,762,4.8
12053,78784,75758,1,1,3026,3.8
12055,37436,35836,1,3,1600,4.3
12057,824322,800135,1,1,24187,2.9
12059,7178,6947,0,8,231,3.2
12061,69755,67295,1,3,2460,3.5
12063,17596,16997,0,6,599,3.4
12065,5770,5586,1,2,184,3.2
12067,2869,2774,0,9,95,3.3
12069,177504,171974,1,1,5530,3.1
12071,378092,366080,1,2,12012,3.2
12073,161608,156589,1,2,5019,3.1
12075,17521,16906,1,2,615,3.5
12077,2653,2566,0,8,87,3.3
12079,8043,7781,0,8,262,3.3
12081,193407,187525,1,2,5882,3
12083,151795,146274,1,2,5521,3.6
12085,77930,75677,1,2,2253,2.9
12086,1377572,1352500,1,1,25072,1.8
12087,49895,48941,0,4,954,1.9
12089,45472,44186,1,1,1286,2.8
12091,104621,101885,1,2,2736,2.6
12093,18116,17534,0,4,582,3.2
12095,820473,797143,1,1,23330,2.8
12097,204145,197266,1,1,6879,3.4
12099,778964,755532,1,1,23432,3
12101,265469,256626,1,1,8843,3.3
12103,523711,509140,1,1,14571,2.8
12105,344422,331847,1,2,12575,3.7
12107,28231,27109,0,4,1122,4
12109,151891,147847,1,1,4044,2.7
12111,159361,153763,1,2,5598,3.5
12113,90137,87574,1,2,2563,2.8
12115,202564,196466,1,2,6098,3
12117,273639,266027,1,1,7612,2.8
12119,38961,37316,1,3,1645,4.2
12121,18069,17454,0,6,615,3.4
12123,8463,8175,0,6,288,3.4
12125,4607,4470,0,8,137,3
12127,271253,262386,1,2,8867,3.3
12129,16141,15698,1,2,443,2.7
12131,35464,34477,1,2,987,2.8
12133,9859,9535,1,3,324,3.3
13000,5305623,5135833,,,169790,3.2
13001,9663,9338,0,7,325,3.4
13003,4268,4136,0,9,132,3.1
13005,5043,4895,0,9,148,2.9
13007,1082,1041,0,8,41,3.8
13009,17399,16674,0,4,725,4.2
13011,11496,11244,0,8,252,2.2
13013,43748,42540,1,1,1208,2.8
13015,53059,51426,1,1,1633,3.1
13017,5665,5420,0,7,245,4.3
13019,7787,7500,0,8,287,3.7
13021,64817,62251,1,3,2566,4
13023,4762,4562,0,6,200,4.2
13025,7561,7298,1,3,263,3.5
13027,6598,6374,1,3,224,3.4
13029,20414,19876,1,2,538,2.6
13031,39023,37715,0,4,1308,3.4
13033,9003,8506,1,2,497,5.5
13035,11492,11154,1,1,338,2.9
13037,2306,2242,0,8,64,2.8
13039,22531,21849,0,4,682,3
13043,6002,5854,0,9,148,2.5
13045,58101,56195,1,1,1906,3.3
13047,34497,33577,1,2,920,2.7
13049,5069,4913,0,8,156,3.1
13051,146009,141723,1,2,4286,2.9
13053,1889,1804,1,2,85,4.5
13055,9382,9036,0,6,346,3.7
13057,144992,141264,1,1,3728,2.6
13059,59574,57598,1,3,1976,3.3
13061,799,737,0,9,62,7.8
13063,142329,136499,1,1,5830,4.1
13065,3075,2988,0,8,87,2.8
13067,438388,426016,1,1,12372,2.8
13069,18822,18144,0,7,678,3.6
13071,21839,21218,0,6,621,2.8
13073,76003,73722,1,2,2281,3
13075,8293,8027,0,6,266,3.2
13077,78953,76649,1,1,2304,2.9
13079,5296,5125,1,3,171,3.2
13081,9873,9509,0,6,364,3.7
13083,8274,8059,1,2,215,2.6
13085,13601,13245,1,1,356,2.6
13087,11465,11071,0,6,394,3.4
13089,411541,397898,1,1,13643,3.3
13091,7101,6829,0,7,272,3.8
13093,4543,4369,0,8,174,3.8
13095,36062,34517,1,3,1545,4.3
13097,76306,73677,1,1,2629,3.4
13099,4003,3848,0,8,155,3.9
13101,1831,1779,1,3,52,2.8
13103,34131,33246,1,2,885,2.6
13105,8181,7888,0,6,293,3.6
13107,8849,8477,0,7,372,4.2
13109,4926,4783,0,8,143,2.9
13111,12179,11836,0,8,343,2.8
13113,60597,58798,1,1,1799,3
13115,46724,45250,1,3,1474,3.2
13117,132233,128872,1,1,3361,2.5
13119,9910,9590,0,8,320,3.2
13121,584831,564799,1,1,20032,3.4
13123,12780,12386,0,6,394,3.1
13125,1237,1195,0,9,42,3.4
13127,40744,39585,1,3,1159,2.8
13129,29080,28219,0,4,861,3
13131,10846,10514,0,6,332,3.1
13133,7583,7331,0,8,252,3.3
13135,508851,494269,1,1,14582,2.9
13137,19415,18809,0,6,606,3.1
13139,111456,108770,1,3,2686,2.4
13141,2450,2316,0,9,134,5.5
13143,13218,12794,1,1,424,3.2
13145,16719,16247,1,2,472,2.8
13147,12724,12350,0,6,374,2.9
13149,5392,5227,1,1,165,3.1
13151,122673,118431,1,1,4242,3.5
13153,71134,69062,1,3,2072,2.9
13155,3496,3358,0,9,138,3.9
13157,49206,48186,0,4,1020,2.1
13159,7298,7089,1,1,209,2.9
13161,6109,5848,0,9,261,4.3
13163,6686,6418,0,8,268,4
13165,3335,3169,0,9,166,5
13167,4112,3993,0,9,119,2.9
13169,13166,12760,1,3,406,3.1
13171,8505,8220,0,6,285,3.4
13173,3765,3621,1,3,144,3.8
13175,19791,18980,0,4,811,4.1
13177,14879,14455,1,3,424,2.8
13179,26226,25365,1,3,861,3.3
13181,3496,3363,1,2,133,3.8
13183,8463,8191,1,3,272,3.2
13185,50299,48548,1,3,1751,3.5
13187,18091,17610,1,1,481,2.7
13189,8436,8026,1,2,410,4.9
13191,6333,6140,1,3,193,3
13193,4556,4363,0,8,193,4.2
13195,13727,13329,1,3,398,2.9
13197,3225,3108,1,2,117,3.6
13199,9088,8736,1,1,352,3.9
13201,2824,2749,0,9,75,2.7
13205,8037,7737,0,6,300,3.7
13207,12646,12274,1,3,372,2.9
13209,3869,3719,0,9,150,3.9
13211,9789,9514,1,1,275,2.8
13213,15498,14862,1,3,636,4.1
13215,75177,71999,1,2,3178,4.2
13217,55216,53114,1,1,2102,3.8
13219,20561,20061,1,3,500,2.4
13221,7074,6874,1,3,200,2.8
13223,92858,90198,1,1,2660,2.9
13225,11898,11441,1,3,457,3.8
13227,16160,15716,1,1,444,2.7
13229,8470,8211,0,8,259,3.1
13231,9315,9061,1,1,254,2.7
13233,18958,18328,0,4,630,3.3
13235,4020,3879,0,8,141,3.5
13237,8899,8561,0,8,338,3.8
13239,726,688,0,8,38,5.2
13241,7832,7597,0,9,235,3
13243,2344,2245,0,8,99,4.2
13245,82954,79146,1,2,3808,4.6
13247,45979,44267,1,1,1712,3.7
13249,2139,2069,0,8,70,3.3
13251,4919,4664,0,8,255,5.2
13253,3074,2958,0,8,116,3.8
13255,29805,28734,1,1,1071,3.6
13257,10409,10032,0,7,377,3.6
13259,2705,2616,1,2,89,3.3
13261,12244,11690,0,6,554,4.5
13263,2831,2738,1,2,93,3.3
13265,554,533,0,8,21,3.8
13267,9343,9046,0,8,297,3.2
13269,2717,2603,0,8,114,4.2
13271,3373,3152,0,9,221,6.6
13273,3438,3285,1,3,153,4.5
13275,17428,16811,0,4,617,3.5
13277,20929,20326,0,5,603,2.9
13279,12152,11693,0,7,459,3.8
13281,4121,3949,0,9,172,4.2
13283,2671,2557,0,9,114,4.3
13285,37855,36784,0,4,1071,2.8
13287,3265,3135,0,9,130,4
13289,2696,2564,1,3,132,4.9
13291,11447,11131,0,8,316,2.8
13293,11634,11232,0,6,402,3.5
13295,32199,31247,1,2,952,3
13297,48730,47291,1,1,1439,3
13299,15092,14590,0,5,502,3.3
13301,2764,2651,0,8,113,4.1
13303,7078,6782,0,7,296,4.2
13305,11959,11565,0,6,394,3.3
13307,987,951,0,8,36,3.6
13309,1627,1536,0,9,91,5.6
13311,17499,17096,0,8,403,2.3
13313,43550,41866,1,3,1684,3.9
13315,2702,2607,0,9,95,3.5
13317,3781,3640,0,8,141,3.7
13319,3391,3262,0,8,129,3.8
13321,8642,8362,1,3,280,3.2
15000,676355,656336,,,20019,3
15001,95112,92251,0,5,2861,3
15003,457540,445151,1,1,12389,2.7
15007,36863,35910,0,5,953,2.6
15009,86842,83025,1,3,3817,4.4
16000,961506,931748,,,29758,3.1
16001,286174,278326,1,2,7848,2.7
16003,1868,1755,0,9,113,6
16005,44267,42897,1,3,1370,3.1
16007,2920,2837,0,9,83,2.8
16009,4263,4049,0,8,214,5
16011,23849,23118,0,6,731,3.1
16013,13823,13450,0,7,373,2.7
16015,4077,3905,1,2,172,4.2
16017,22417,21443,0,6,974,4.3
16019,65279,63581,1,3,1698,2.6
16021,5517,5260,0,9,257,4.7
16023,1196,1149,1,3,47,3.9
16025,561,543,0,9,18,3.2
16027,116741,112767,1,2,3974,3.4
16029,3677,3563,0,8,114,3.1
16031,12340,12014,0,6,326,2.6
16033,474,459,0,8,15,3.2
16035,3431,3236,0,8,195,5.7
16037,2017,1941,0,8,76,3.8
16039,12575,12165,0,6,410,3.3
16041,7105,6914,1,3,191,2.7
16043,7884,7681,0,8,203,2.6
16045,8774,8442,1,2,332,3.8
16047,8159,7913,0,8,246,3
16049,7410,7113,0,8,297,4
16051,15546,15148,1,3,398,2.6
16053,11904,11537,1,3,367,3.1
16055,87778,84596,1,3,3182,3.6
16057,20715,20157,0,4,558,2.7
16059,4072,3918,0,9,154,3.8
16061,1663,1606,0,8,57,3.4
16063,2509,2411,0,8,98,3.9
16065,24051,23528,0,4,523,2.2
16067,11987,11660,0,7,327,2.7
16069,21717,21114,1,3,603,2.8
16071,2427,2354,0,8,73,3
16073,5585,5369,1,2,216,3.9
16075,11581,11139,0,6,442,3.8
16077,4031,3877,0,8,154,3.8
16079,5779,5478,0,8,301,5.2
16081,7931,7749,0,9,182,2.3
16083,44482,43057,1,3,1425,3.2
16085,6380,6144,0,9,236,3.7
16087,4573,4389,0,6,184,4
17000,6437855,6150672,,,287183,4.5
17001,30918,29796,0,5,1122,3.6
17003,1811,1697,1,3,114,6.3
17005,7573,7252,1,1,321,4.2
17007,24945,23187,1,2,1758,7
17009,3095,3022,0,9,73,2.4
17011,15776,14878,0,7,898,5.7
17013,2197,2104,1,1,93,4.2
17015,7234,6917,0,9,317,4.4
17017,5801,5547,0,6,254,4.4
17019,111823,107193,1,3,4630,4.1
17021,13545,12860,0,6,685,5.1
17023,7274,6937,0,8,337,4.6
17025,5765,5458,0,9,307,5.3
17027,20138,19483,1,1,655,3.3
17029,22868,21858,0,5,1010,4.4
17031,2651912,2534647,1,1,117265,4.4
17033,8541,8198,0,6,343,4
17035,6017,5809,0,9,208,3.5
17037,54336,51794,1,1,2542,4.7
17039,7511,7184,0,6,327,4.4
17041,10228,9858,0,8,370,3.6
17043,519060,501563,1,1,17497,3.4
17045,9022,8686,0,6,336,3.7
17047,2570,2450,0,9,120,4.7
17049,19570,18935,0,7,635,3.2
17051,9723,9247,0,6,476,4.9
17053,6446,6164,1,3,282,4.4
17055,15856,14987,0,7,869,5.5
17057,14571,13793,0,6,778,5.3
17059,2044,1933,0,8,111,5.4
17061,5803,5545,0,8,258,4.4
17063,26233,25038,1,1,1195,4.6
17065,4332,4168,0,9,164,3.8
17067,7901,7578,0,9,323,4.1
17069,1443,1363,0,9,80,5.5
17071,3517,3371,0,9,146,4.2
17073,23658,22487,1,2,1171,4.9
17075,12913,12319,0,8,594,4.6
17077,27151,25958,0,5,1193,4.4
17079,4841,4646,0,9,195,4
17081,16291,15524,0,7,767,4.7
17083,10702,10285,1,1,417,3.9
17085,10609,10176,0,8,433,4.1
17087,4104,3865,0,8,239,5.8
17089,266988,253340,1,1,13648,5.1
17091,51960,48925,1,3,3035,5.8
17093,72627,69846,1,1,2781,3.8
17095,20108,19003,0,4,1105,5.5
17097,366879,348404,1,1,18475,5
17099,51410,48433,0,4,2977,5.8
17101,5056,4786,0,9,270,5.3
17103,16805,16066,0,6,739,4.4
17105,16136,15478,0,6,658,4.1
17107,11345,10811,0,6,534,4.7
17109,12780,12188,0,7,592,4.6
17111,169714,163379,1,1,6335,3.7
17113,90686,87190,1,3,3496,3.9
17115,45206,42474,1,3,2732,6
17117,22355,21437,1,1,918,4.1
17119,132488,127016,1,1,5472,4.1
17121,16872,16050,0,7,822,4.9
17123,5145,4878,1,2,267,5.2
17125,5929,5620,0,8,309,5.2
17127,5378,5107,1,3,271,5
17129,6193,5951,1,3,242,3.9
17131,7546,7191,1,2,355,4.7
17133,18849,18270,1,1,579,3.1
17135,11368,10792,0,6,576,5.1
17137,15579,14929,0,4,650,4.2
17139,7201,6940,0,8,261,3.6
17141,23807,22525,0,6,1282,5.4
17143,82402,77895,1,2,4507,5.5
17145,7734,7324,0,7,410,5.3
17147,8803,8470,1,3,333,3.8
17149,6704,6399,0,9,305,4.5
17151,1799,1728,0,8,71,3.9
17153,1644,1518,0,8,126,7.7
17155,2963,2796,0,8,167,5.6
17157,13336,12802,0,6,534,4
17159,7255,6949,0,7,306,4.2
17161,67181,63749,1,2,3432,5.1
17163,124359,118597,1,1,5762,4.6
17165,9590,9113,0,7,477,5
17167,97376,93210,1,3,4166,4.3
17169,3160,3023,0,9,137,4.3
17171,2292,2175,0,9,117,5.1
17173,9921,9489,0,8,432,4.4
17175,2410,2275,1,2,135,5.6
17177,20962,19909,0,4,1053,5
17179,62018,59204,1,2,2814,4.5
17181,7109,6722,0,6,387,5.4
17183,31898,30042,0,4,1856,5.8
17185,5547,5357,0,7,190,3.4
17187,8007,7672,0,6,335,4.2
17189,9708,9440,0,8,268,2.8
17191,6925,6609,0,9,316,4.6
17193,6074,5824,0,6,250,4.1
17195,27535,26252,0,4,1283,4.7
17197,367740,352251,1,1,15489,4.2
17199,31045,29675,0,5,1370,4.4
17201,132003,123860,1,2,8143,6.2
17203,18286,17558,1,2,728,4
18000,3401387,3288017,,,113370,3.3
18001,16809,16352,0,6,457,2.7
18003,189514,183577,1,2,5937,3.1
18005,44070,42843,1,3,1227,2.8
18007,4527,4409,1,3,118,2.6
18009,4795,4605,0,6,190,4
18011,38693,37724,1,1,969,2.5
18013,7919,7661,1,1,258,3.3
18015,10171,9873,1,3,298,2.9
18017,17431,16780,0,4,651,3.7
18019,63165,61228,1,1,1937,3.1
18021,11589,11192,1,3,397,3.4
18023,17583,17124,0,6,459,2.6
18025,4814,4643,0,8,171,3.6
18027,16995,16594,0,7,401,2.4
18029,26168,25315,1,1,853,3.3
18031,14587,14192,0,6,395,2.7
18033,22199,21544,0,4,655,3
18035,51390,49419,1,3,1971,3.8
18037,21994,21444,0,5,550,2.5
18039,110513,106100,1,3,4413,4
18041,8330,7965,0,6,365,4.4
18043,42544,41356,1,1,1188,2.8
18045,8095,7846,0,8,249,3.1
18047,11306,10950,1,1,356,3.1
18049,9537,9204,0,7,333,3.5
18051,19625,19152,0,6,473,2.4
18053,31150,30066,0,4,1084,3.5
18055,13525,12996,0,6,529,3.9
18057,197462,192441,1,1,5021,2.5
18059,43197,41987,1,1,1210,2.8
18061,20617,20030,1,1,587,2.8
18063,96080,93528,1,1,2552,2.7
18065,22242,21483,0,6,759,3.4
18067,33780,32090,1,3,1690,5
18069,18316,17771,0,6,545,3
18071,22875,22225,0,4,650,2.8
18073,16082,15507,1,1,575,3.6
18075,8921,8648,0,6,273,3.1
18077,15064,14597,0,6,467,3.1
18079,13570,13113,0,6,457,3.4
18081,87829,85481,1,1,2348,2.7
18083,17939,17404,0,7,535,3
18085,40657,39287,0,4,1370,3.4
18087,21002,20352,0,8,650,3.1
18089,228991,217531,1,1,11460,5
18091,47678,45780,1,3,1898,4
18093,20095,19325,0,6,770,3.8
18095,60874,58699,1,1,2175,3.6
18097,511700,494846,1,1,16854,3.3
18099,23474,22677,0,6,797,3.4
18101,5315,5164,0,9,151,2.8
18103,14443,13875,0,6,568,3.9
18105,70790,68480,1,3,2310,3.3
18107,18930,18404,0,6,526,2.8
18109,37754,36611,1,1,1143,3
18111,6825,6560,1,1,265,3.9
18113,22386,21565,0,6,821,3.7
18115,3234,3138,1,1,96,3
18117,8283,7999,0,8,284,3.4
18119,9366,9022,1,3,344,3.7
18121,7276,7039,0,8,237,3.3
18123,9100,8830,0,7,270,3
18125,5849,5658,0,8,191,3.3
18127,86290,83108,1,1,3182,3.7
18129,13044,12691,1,2,353,2.7
18131,6833,6636,0,8,197,2.9
18133,17090,16550,0,6,540,3.2
18135,11701,11321,0,6,380,3.2
18137,12664,12223,0,6,441,3.5
18139,9020,8773,0,6,247,2.7
18141,132300,127174,1,2,5126,3.9
18143,10616,10248,0,6,368,3.5
18145,23965,23305,1,1,660,2.8
18147,10715,10399,0,8,316,2.9
18149,9673,9274,0,8,399,4.1
18151,20823,20263,0,7,560,2.7
18153,7964,7664,1,3,300,3.8
18155,4713,4560,0,8,153,3.2
18157,99118,96206,1,3,2912,2.9
18159,9014,8747,1,1,267,3
18161,3624,3518,0,8,106,2.9
18163,92142,89226,1,2,2916,3.2
18165,6585,6313,1,3,272,4.1
18167,45640,43913,1,3,1727,3.8
18169,14936,14476,0,6,460,3.1
18171,4146,4024,1,3,122,2.9
18173,32342,31393,1,2,949,2.9
18175,13956,13530,1,1,426,3.1
18177,29586,28566,0,5,1020,3.4
18179,14424,14036,1,2,388,2.7
18181,13505,13143,0,6,362,2.7
18183,17928,17436,1,2,492,2.7
19000,1709402,1659106,,,50296,2.9
19001,4415,4310,0,8,105,2.4
19003,2054,2008,0,9,46,2.2
19005,7108,6835,0,8,273,3.8
19007,6028,5831,0,7,197,3.3
19009,3166,3095,0,9,71,2.2
19011,12997,12565,1,2,432,3.3
19013,67072,64918,1,3,2154,3.2
19015,14968,14597,1,3,371,2.5
19017,13877,13528,1,3,349,2.5
19019,11223,10895,0,6,328,2.9
19021,12156,11869,0,7,287,2.4
19023,8170,7918,0,8,252,3.1
19025,4150,4037,0,9,113,2.7
19027,10534,10286,0,7,248,2.4
19029,6919,6734,0,6,185,2.7
19031,10486,10174,0,8,312,3
19033,22175,21495,0,5,680,3.1
19035,6110,5959,0,9,151,2.5
19037,6556,6393,0,8,163,2.5
19039,5042,4898,0,6,144,2.9
19041,8577,8329,0,7,248,2.9
19043,9557,9177,0,8,380,4
19045,21868,21048,0,4,820,3.7
19047,7794,7420,0,7,374,4.8
19049,54766,53556,1,2,1210,2.2
19051,4332,4226,0,9,106,2.4
19053,4334,4228,0,9,106,2.4
19055,10407,10134,0,8,273,2.6
19057,17927,17181,0,5,746,4.2
19059,10669,10360,0,7,309,2.9
19061,55798,54177,1,3,1621,2.9
19063,4810,4659,0,7,151,3.1
19065,10518,10179,0,6,339,3.2
19067,8380,8098,0,7,282,3.4
19069,5703,5545,0,9,158,2.8
19071,3690,3605,0,8,85,2.3
19073,5297,5178,0,8,119,2.2
19075,6382,6204,1,3,178,2.8
19077,5749,5578,1,2,171,3
19079,6998,6807,0,6,191,2.7
19081,5637,5481,0,9,156,2.8
19083,7904,7660,0,6,244,3.1
19085,7182,6987,1,2,195,2.7
19087,9173,8870,0,6,303,3.3
19089,5302,5133,0,8,169,3.2
19091,4980,4847,0,7,133,2.7
19093,3919,3837,0,8,82,2.1
19095,9907,9633,0,8,274,2.8
19097,10591,10223,0,6,368,3.5
19099,18653,18086,1,2,567,3
19101,10133,9861,0,7,272,2.7
19103,86703,84619,1,3,2084,2.4
19105,10330,9967,1,2,363,3.5
19107,5266,5094,0,8,172,3.3
19109,8248,8043,0,7,205,2.5
19111,14604,14005,0,7,599,4.1
19113,119470,115327,1,2,4143,3.5
19115,5961,5769,0,8,192,3.2
19117,4478,4369,0,8,109,2.4
19119,7209,7066,0,8,143,2
19121,8924,8615,1,2,309,3.5
19123,12201,11884,0,7,317,2.6
19125,19395,18962,0,6,433,2.2
19127,17428,16322,0,4,1106,6.3
19129,7168,6978,1,2,190,2.7
19131,5836,5704,0,9,132,2.3
19133,4396,4273,0,8,123,2.8
19135,4171,4056,0,9,115,2.8
19137,4996,4864,0,6,132,2.6
19139,20636,19980,0,4,656,3.2
19141,8237,8040,0,7,197,2.4
19143,3648,3578,0,9,70,1.9
19145,6570,6400,0,6,170,2.6
19147,4481,4368,0,9,113,2.5
19149,14842,14529,0,6,313,2.1
19151,3996,3904,0,9,92,2.3
19153,280238,272194,1,2,8044,2.9
19155,47918,46534,1,2,1384,2.9
19157,10292,9991,0,6,301,2.9
19159,2349,2297,0,9,52,2.2
19161,5305,5178,0,9,127,2.4
19163,87630,84595,1,2,3035,3.5
19165,6446,6289,0,8,157,2.4
19167,23233,22796,0,6,437,1.9
19169,59645,58367,1,3,1278,2.1
19171,9237,8874,0,6,363,3.9
19173,3146,3076,0,9,70,2.2
19175,5959,5779,0,6,180,3
19177,3662,3550,0,9,112,3.1
19179,16714,16132,0,5,582,3.5
19181,29739,28966,1,2,773,2.6
19183,11794,11487,1,3,307,2.6
19185,3017,2928,0,9,89,2.9
19187,18643,18062,0,5,581,3.1
19189,4922,4735,0,9,187,3.8
19191,11600,11227,0,7,373,3.2
19193,55965,54358,1,3,1607,2.9
19195,4027,3908,0,9,119,3
19197,6588,6418,0,9,170,2.6
2000,357094,342005,,,15089,4.2
20000,1510988,1470936,,,40052,2.7
20001,6114,5942,0,7,172,2.8
20003,4409,4316,0,8,93,2.1
20005,6752,6525,0,6,227,3.4
20007,2259,2204,0,9,55,2.4
20009,12792,12451,0,7,341,2.7
20011,6204,5993,0,6,211,3.4
20013,4577,4448,0,8,129,2.8
20015,33100,32218,1,2,882,2.7
20017,1238,1209,0,8,29,2.3
20019,1385,1346,0,9,39,2.8
20021,10012,9743,1,3,269,2.7
20023,1219,1188,0,9,31,2.5
20025,1104,1082,0,9,22,2
20027,3691,3597,0,8,94,2.5
20029,3712,3609,0,7,103,2.8
20031,3672,3551,0,8,121,3.3
20033,857,835,0,9,22,2.6
20035,16200,15715,0,4,485,3
20037,19102,18559,0,4,543,2.8
20039,1178,1144,0,9,34,2.9
20041,8619,8374,0,6,245,2.8
20043,4027,3926,1,3,101,2.5
20045,66580,64860,1,3,1720,2.6
20047,1365,1333,0,9,32,2.3
20049,1169,1140,0,8,29,2.5
20051,17173,16842,0,5,331,1.9
20053,2551,2491,0,9,60,2.4
20055,20564,20139,0,5,425,2.1
20057,17709,17331,0,5,378,2.1
20059,14998,14621,0,6,377,2.5
20061,11099,10673,1,3,426,3.8
20063,1306,1276,0,9,30,2.3
20065,1153,1123,0,9,30,2.6
20067,2798,2722,0,7,76,2.7
20069,3172,3109,0,9,63,2
20071,765,751,0,9,14,1.8
20073,3021,2938,0,8,83,2.7
20075,1619,1590,0,9,29,1.8
20077,2797,2732,0,8,65,2.3
20079,17372,16866,1,2,506,2.9
20081,2115,2073,0,9,42,2
20083,988,966,0,9,22,2.2
20085,7361,7189,1,3,172,2.3
20087,10454,10195,1,3,259,2.5
20089,1143,1111,0,9,32,2.8
20091,352969,344449,1,1,8520,2.4
20093,1952,1913,0,9,39,2
20095,3304,3215,0,8,89,2.7
20097,1185,1155,0,9,30,2.5
20099,9384,9108,0,7,276,2.9
20101,704,685,0,9,19,2.7
20103,37723,36702,1,1,1021,2.7
20105,1641,1606,0,9,35,2.1
20107,4394,4224,1,1,170,3.9
20109,1636,1607,0,9,29,1.8
20111,16840,16400,0,4,440,2.6
20113,17596,17250,0,7,346,2
20115,5945,5799,0,8,146,2.5
20117,5300,5187,0,8,113,2.1
20119,2095,2051,0,9,44,2.1
20121,18198,17730,1,1,468,2.6
20123,3321,3256,0,9,65,2
20125,14732,14293,0,7,439,3
20127,2930,2857,0,8,73,2.5
20129,1104,1075,0,9,29,2.6
2013,2522,2469,0,9,53,2.1
20131,5896,5795,0,9,101,1.7
20133,6169,5951,0,7,218,3.5
20135,1289,1258,0,9,31,2.4
20137,2602,2550,0,9,52,2
20139,8082,7868,1,3,214,2.6
20141,1769,1730,0,9,39,2.2
20143,3000,2931,0,9,69,2.3
20145,2660,2592,0,9,68,2.6
20147,2579,2523,0,9,56,2.2
20149,12676,12382,1,3,294,2.3
20151,4876,4773,0,7,103,2.1
20153,1510,1481,0,9,29,1.9
20155,28928,28095,0,4,833,2.9
20157,2358,2309,0,9,49,2.1
20159,5136,5006,0,9,130,2.5
2016,3553,3446,0,9,107,3
20161,35130,34229,1,3,901,2.6
20163,2338,2278,0,9,60,2.6
20165,1620,1584,0,9,36,2.2
20167,3289,3212,0,9,77,2.3
20169,30115,29383,0,5,732,2.4
20171,2613,2562,0,9,51,2
20173,258378,250765,1,2,7613,2.9
20175,9687,9444,0,7,243,2.5
20177,92894,90376,1,3,2518,2.7
20179,1393,1364,0,9,29,2.1
20181,2750,2685,0,9,65,2.4
20183,2012,1971,0,9,41,2
20185,1890,1846,0,9,44,2.3
20187,1049,1027,0,9,22,2.1
20189,2745,2686,0,9,59,2.1
20191,10861,10566,1,2,295,2.7
20193,4216,4137,0,7,79,1.9
20195,1285,1247,0,9,38,3
20197,3774,3676,1,3,98,2.6
20199,862,843,0,9,19,2.2
2020,150823,145654,1,2,5169,3.4
20201,2985,2921,0,9,64,2.1
20203,1088,1064,0,9,24,2.2
20205,3686,3572,0,9,114,3.1
20207,1492,1442,0,9,50,3.4
20209,78869,76210,1,1,2659,3.4
2050,6743,6088,0,7,655,9.7
2060,461,444,0,9,17,3.7
2063,3460,3297,0,9,163,4.7
2066,1378,1273,0,9,105,7.6
2068,1041,979,0,9,62,6
2070,1729,1619,0,9,110,6.4
2090,45499,43768,1,3,1731,3.8
2100,1111,1038,0,9,73,6.6
21000,2026263,1941994,,,84269,4.2
21001,7216,6853,0,7,363,5
21003,8918,8562,1,3,356,4
21005,12026,11627,0,6,399,3.3
21007,3459,3290,1,3,169,4.9
21009,17675,16899,0,6,776,4.4
21011,4571,4313,0,8,258,5.6
21013,8259,7795,0,7,464,5.6
21015,71478,68936,1,1,2542,3.6
21017,9382,9047,1,2,335,3.6
21019,17030,16077,1,2,953,5.6
21021,12548,11980,0,7,568,4.5
21023,3738,3564,1,1,174,4.7
21025,3155,2917,0,9,238,7.5
21027,7869,7485,0,8,384,4.9
21029,42406,40677,1,1,1729,4.1
21031,5031,4804,1,3,227,4.5
21033,5714,5492,0,7,222,3.9
21035,17096,16346,0,7,750,4.4
21037,50200,48376,1,1,1824,3.6
21039,2191,2105,1,3,86,3.9
21041,5460,5267,0,6,193,3.5
21043,9599,8871,1,2,728,7.6
21045,6535,6266,0,9,269,4.1
21047,24573,23327,1,2,1246,5.1
21049,17231,16581,1,2,650,3.8
2105,1289,1217,0,9,72,5.6
21051,5071,4748,0,9,323,6.4
21053,3430,3252,0,9,178,5.2
21055,3720,3568,0,8,152,4.1
21057,3456,3339,0,9,117,3.4
21059,44563,42641,1,3,1922,4.3
21061,4769,4527,1,3,242,5.1
21063,1879,1724,0,8,155,8.2
21065,5138,4882,0,8,256,5
21067,175552,169623,1,2,5929,3.4
21069,5886,5603,0,9,283,4.8
21071,10873,10222,0,7,651,6
21073,25227,24331,0,4,896,3.6
21075,2104,1999,0,9,105,5
21077,3951,3792,1,1,159,4
21079,7901,7591,0,8,310,3.9
21081,11557,11089,1,1,468,4
21083,15387,14741,0,6,646,4.2
21085,10268,9797,0,6,471,4.6
21087,4983,4794,0,8,189,3.8
21089,12840,12001,1,2,839,6.5
21091,3710,3541,0,8,169,4.6
21093,47422,45471,1,3,1951,4.1
21095,6329,5911,0,7,418,6.6
21097,8776,8446,0,6,330,3.8
21099,7525,7194,0,8,331,4.4
2110,17471,16948,0,5,523,3
21101,20182,19378,0,4,804,4
21103,7975,7683,1,1,292,3.7
21105,1632,1559,0,8,73,4.5
21107,18255,17447,0,5,808,4.4
21109,4116,3884,0,9,232,5.6
21111,389522,374287,1,1,15235,3.9
21113,26587,25657,1,2,930,3.5
21115,6681,6242,0,7,439,6.6
21117,86915,83716,1,1,3199,3.7
21119,4256,3972,0,9,284,6.7
21121,9782,9210,0,7,572,5.8
21123,5781,5526,1,3,255,4.4
21125,24678,23568,0,5,1110,4.5
21127,5594,5273,1,2,321,5.7
21129,2155,2030,0,9,125,5.8
21131,2504,2331,0,9,173,6.9
21133,5959,5586,0,9,373,6.3
21135,4433,4077,0,8,356,8
21137,9182,8710,0,9,472,5.1
21139,3637,3454,1,3,183,5
21141,12126,11627,0,6,499,4.1
21143,3153,3014,0,8,139,4.4
21145,29813,28607,1,3,1206,4
21147,4638,4363,0,9,275,5.9
21149,3832,3655,1,3,177,4.6
21151,46796,44992,0,4,1804,3.9
21153,3122,2815,0,9,307,9.8
21155,9405,9081,0,6,324,3.4
21157,14891,14300,0,8,591,4
21159,2198,2015,0,8,183,8.3
21161,6465,6132,0,6,333,5.2
21163,11706,11170,1,1,536,4.6
21165,2311,2167,0,9,144,6.2
21167,10176,9763,0,6,413,4.1
21169,3846,3663,0,9,183,4.8
21171,4444,4254,0,8,190,4.3
21173,11560,11007,0,6,553,4.8
21175,4370,4146,0,9,224,5.1
21177,9886,9283,0,6,603,6.1
21179,23669,22821,1,1,848,3.6
21181,3302,3161,0,8,141,4.3
21183,9009,8508,0,6,501,5.6
21185,32836,31725,1,1,1111,3.4
21187,5167,4974,0,8,193,3.7
21189,1090,1018,0,9,72,6.6
21191,6857,6584,1,1,273,4
21193,7982,7535,0,7,447,5.6
21195,18898,17828,0,7,1070,5.7
21197,5137,4911,0,8,226,4.4
21199,25038,23829,0,5,1209,4.8
21201,784,743,0,8,41,5.2
21203,6464,6163,0,9,301,4.7
21205,10178,9648,0,6,530,5.2
21207,6333,5996,0,9,337,5.3
21209,30322,29308,1,2,1014,3.3
21211,25416,24531,1,1,885,3.5
21213,8963,8626,0,6,337,3.8
21215,10414,10029,1,1,385,3.7
21217,11997,11541,0,7,456,3.8
21219,5690,5476,0,8,214,3.8
2122,28170,26841,0,7,1329,4.7
21221,5963,5684,1,2,279,4.7
21223,3743,3598,0,8,145,3.9
21225,5829,5546,0,8,283,4.9
21227,66253,63646,1,3,2607,3.9
21229,6195,5989,0,8,206,3.3
21231,6813,6432,0,7,381,5.6
21233,5179,4961,0,9,218,4.2
21235,13680,13026,0,7,654,4.8
21237,2110,1977,0,9,133,6.3
21239,14718,14259,1,2,459,3.1
2130,6883,6630,0,7,253,3.7
2150,5984,5720,0,7,264,4.4
2158,2298,1952,0,9,346,15.1
2164,663,624,0,9,39,5.9
2170,49710,47311,1,2,2399,4.8
2180,4049,3738,0,9,311,7.7
2185,3064,2913,0,9,151,4.9
2188,2803,2533,0,9,270,9.6
2195,1398,1327,0,9,71,5.1
2198,2670,2490,0,9,180,6.7
22000,2076760,2000152,,,76608,3.7
22001,23860,22974,1,2,886,3.7
22003,8143,7801,0,6,342,4.2
22005,66938,64952,1,2,1986,3
22007,8783,8402,1,2,381,4.3
22009,14480,13869,0,6,611,4.2
22011,14551,14030,0,6,521,3.6
22013,5101,4880,0,8,221,4.3
22015,57979,56104,1,2,1875,3.2
22017,101375,97264,1,2,4111,4.1
22019,91057,87920,1,2,3137,3.4
22021,3690,3544,0,8,146,4
22023,3382,3288,1,2,94,2.8
22025,3594,3440,0,9,154,4.3
22027,5402,5188,0,9,214,4
22029,6895,6570,0,6,325,4.7
22031,10916,10465,1,2,451,4.1
22033,233437,225501,1,2,7936,3.4
22035,1683,1535,0,8,148,8.8
22037,7918,7640,1,2,278,3.5
22039,12200,11721,0,6,479,3.9
22041,7295,6917,0,6,378,5.2
22043,8113,7812,1,3,301,3.7
22045,27524,26391,0,4,1133,4.1
22047,13889,13309,1,2,580,4.2
22049,7146,6912,0,6,234,3.3
22051,209182,201929,1,1,7253,3.5
22053,12205,11745,1,2,460,3.8
22055,116181,112473,1,2,3708,3.2
22057,41281,39973,1,3,1308,3.2
22059,6567,6368,0,8,199,3
22061,21226,20425,0,4,801,3.8
22063,71823,69688,1,2,2135,3
22065,3483,3292,0,6,191,5.5
22067,9584,9015,1,3,569,5.9
22069,17347,16642,0,6,705,4.1
22071,175616,167786,1,1,7830,4.5
22073,69852,67209,1,3,2643,3.8
22075,9762,9443,1,1,319,3.3
22077,9800,9432,1,2,368,3.8
22079,54680,52770,1,3,1910,3.5
22081,3788,3655,0,8,133,3.5
22083,8167,7793,1,3,374,4.6
22085,9367,9013,0,8,354,3.8
22087,19937,19099,1,1,838,4.2
22089,24650,23859,1,1,791,3.2
22091,4276,4050,1,2,226,5.3
22093,8863,8467,1,1,396,4.5
22095,18901,18067,1,1,834,4.4
22097,31808,30384,0,4,1424,4.5
22099,22012,21227,1,2,785,3.6
22101,19061,18261,0,4,800,4.2
22103,119486,115587,1,2,3899,3.3
22105,57358,54898,1,3,2460,4.3
22107,1322,1254,0,9,68,5.1
22109,45309,43778,1,3,1531,3.4
22111,9144,8763,1,3,381,4.2
22113,24038,23164,1,2,874,3.6
22115,16298,15551,0,4,747,4.6
22117,17141,16409,0,6,732,4.3
22119,14161,13537,0,6,624,4.4
22121,14014,13554,1,2,460,3.3
22123,3460,3245,0,8,215,6.2
22125,5447,5303,1,2,144,2.6
22127,4821,4618,0,8,203,4.2
2220,4519,4385,0,7,134,3
2230,773,728,0,9,45,5.8
2240,3397,3220,0,9,177,5.2
2275,926,881,0,9,45,4.9
2282,315,296,0,9,19,6
2290,2392,2176,0,8,216,9
23000,687322,667619,,,19703,2.9
23001,53756,52165,1,3,1591,3
23003,28620,27505,0,7,1115,3.9
23005,166187,162199,1,2,3988,2.4
23007,13791,13303,0,8,488,3.5
23009,28728,27799,0,8,929,3.2
23011,62344,60714,0,4,1630,2.6
23013,19993,19419,0,7,574,2.9
23015,16835,16366,0,8,469,2.8
23017,26211,25375,0,6,836,3.2
23019,74441,72160,1,3,2281,3.1
23021,7100,6802,0,8,298,4.2
23023,19223,18780,1,2,443,2.3
23025,22088,21166,0,6,922,4.2
23027,20329,19714,0,8,615,3
23029,13400,12847,0,9,553,4.1
23031,114268,111302,1,2,2966,2.6
24000,3184868,3117270,,,67598,2.1
24001,30799,29936,0,4,863,2.8
24003,315180,309390,1,1,5790,1.8
24005,445794,436039,1,1,9755,2.2
24009,49497,48567,1,3,930,1.9
24011,16828,16470,0,6,358,2.1
24013,95290,93664,1,1,1626,1.7
24015,54798,53591,1,1,1207,2.2
24017,86748,84864,1,1,1884,2.2
24019,16290,15919,0,6,371,2.3
24021,136641,133976,1,1,2665,2
24023,14896,14551,0,8,345,2.3
24025,140714,137931,1,1,2783,2
24027,188575,185359,1,1,3216,1.7
24029,9869,9636,0,6,233,2.4
24031,548380,538156,1,1,10224,1.9
24033,497045,485870,1,1,11175,2.2
24035,28253,27750,1,1,503,1.8
24037,58431,57277,1,3,1154,2
24039,9215,8924,1,3,291,3.2
24041,17390,17008,0,6,382,2.2
24043,72266,70594,1,2,1672,2.3
24045,52107,50783,1,3,1324,2.5
24047,25589,24739,0,4,850,3.3
24510,274275,266276,1,1,7999,2.9
25000,3751662,3625293,,,126369,3.4
25001,112130,107428,1,3,4702,4.2
25003,61722,59489,1,3,2233,3.6
25005,298748,286506,1,1,12242,4.1
25007,9734,9310,0,7,424,4.4
25009,423500,408785,1,1,14715,3.5
25011,39803,38667,0,4,1136,2.9
25013,220071,210703,1,2,9368,4.3
25015,88097,85499,1,3,2598,2.9
25017,915035,888841,1,1,26194,2.9
25019,8163,7690,0,7,473,5.8
25021,394835,382700,1,1,12135,3.1
25023,283965,273935,1,1,10030,3.5
25025,455156,440449,1,1,14707,3.2
25027,440698,425288,1,2,15410,3.5
26000,5007904,4812421,,,195483,3.9
26001,3640,3375,0,9,265,7.3
26003,3324,3069,0,9,255,7.7
26005,64721,62513,0,4,2208,3.4
26007,14106,13465,0,7,641,4.5
26009,10418,9860,0,8,558,5.4
26011,6023,5606,0,8,417,6.9
26013,3217,3017,0,9,200,6.2
26015,33177,32002,1,1,1175,3.5
26017,49857,47400,1,3,2457,4.9
26019,9110,8659,1,3,451,5
26021,74317,71189,1,3,3128,4.2
26023,20225,19439,0,6,786,3.9
26025,61844,59159,1,3,2685,4.3
26027,24253,23178,1,2,1075,4.4
26029,13132,12532,0,7,600,4.6
26031,10404,9551,0,7,853,8.2
26033,16360,15393,0,7,967,5.9
26035,11882,11132,0,8,750,6.3
26037,42145,40741,1,2,1404,3.3
26039,5686,5353,0,9,333,5.9
26041,16956,16074,0,5,882,5.2
26043,12660,12179,0,7,481,3.8
26045,58360,56252,1,2,2108,3.6
26047,16641,15687,0,7,954,5.7
26049,183762,174637,1,2,9125,5
26051,10362,9754,0,8,608,5.9
26053,5922,5641,0,7,281,4.7
26055,51382,49642,1,3,1740,3.4
26057,17953,17168,0,6,785,4.4
26059,20699,19821,0,6,878,4.2
26061,17134,16341,0,5,793,4.6
26063,15589,14913,0,9,676,4.3
26065,152912,147008,1,2,5904,3.9
26067,31530,30389,1,1,1141,3.6
26069,10485,9860,0,7,625,6
26071,4926,4650,0,9,276,5.6
26073,32466,31000,0,4,1466,4.5
26075,75244,72215,1,3,3029,4
26077,135381,130403,1,2,4978,3.7
26079,8184,7729,1,3,455,5.6
26081,374650,362728,1,1,11922,3.2
26083,958,901,0,9,57,5.9
26085,3961,3683,0,9,278,7
26087,41690,39977,1,1,1713,4.1
26089,10747,10341,1,3,406,3.8
26091,46258,44324,0,4,1934,4.2
26093,106428,103521,1,1,2907,2.7
26095,2256,2123,0,9,133,5.9
26097,5392,4910,0,9,482,8.9
26099,455508,439505,1,1,16003,3.5
26101,9939,9369,0,6,570,5.7
26103,32840,31323,0,5,1517,4.6
26105,13448,12787,0,7,661,4.9
26107,18963,17952,0,6,1011,5.3
26109,10886,10453,0,7,433,4
26111,40812,39192,1,3,1620,4
26113,7098,6758,0,8,340,4.8
26115,77534,74284,1,3,3250,4.2
26117,29072,27831,1,1,1241,4.3
26119,3135,2900,0,9,235,7.5
26121,79360,75829,1,3,3531,4.4
26123,23880,22854,0,6,1026,4.3
26125,687933,667877,1,1,20056,2.9
26127,11850,11171,0,8,679,5.7
26129,8441,7882,0,9,559,6.6
26131,2087,1941,0,9,146,7
26133,12309,11724,0,9,585,4.8
26135,2843,2626,0,9,217,7.6
26137,11851,11284,0,7,567,4.8
26139,168938,163800,1,1,5138,3
26141,5045,4659,0,9,386,7.7
26143,8812,8175,0,7,637,7.2
26145,84315,79942,1,3,4373,5.2
26147,77012,74088,1,1,2924,3.8
26149,28892,27631,0,4,1261,4.4
26151,19809,18849,0,8,960,4.8
26153,3316,3075,0,9,241,7.3
26155,33491,32039,0,4,1452,4.3
26157,24079,22875,0,6,1204,5
26159,35558,33877,0,6,1681,4.7
26161,200968,194354,1,2,6614,3.3
26163,813992,778572,1,1,35420,4.4
26165,15167,14445,0,6,722,4.8
27000,3099923,3012707,,,87216,2.8
27001,7514,7155,0,8,359,4.8
27003,199737,194226,1,1,5511,2.8
27005,19513,18931,0,6,582,3
27007,25182,24303,0,7,879,3.5
27009,21827,21039,1,3,788,3.6
27011,2399,2318,0,9,81,3.4
27013,40911,39965,1,3,946,2.3
27015,13991,13583,0,6,408,2.9
27017,17614,16964,1,2,650,3.7
27019,59767,58305,1,1,1462,2.4
27021,14948,14291,0,9,657,4.4
27023,6462,6280,0,7,182,2.8
27025,30171,29170,1,1,1001,3.3
27027,38044,37255,1,3,789,2.1
27029,4550,4277,0,8,273,6
27031,2901,2796,0,9,105,3.6
27033,6324,6031,0,9,293,4.6
27035,33916,32752,0,4,1164,3.4
27037,243607,237392,1,1,6215,2.6
27039,12051,11710,1,3,341,2.8
27041,21680,21107,0,6,573,2.6
27043,7098,6880,0,8,218,3.1
27045,11580,11254,1,3,326,2.8
27047,15921,15487,0,7,434,2.7
27049,27017,26303,0,6,714,2.6
27051,3259,3154,0,9,105,3.2
27053,708159,689878,1,1,18281,2.6
27055,10479,10216,1,3,263,2.5
27057,10253,9811,0,9,442,4.3
27059,21924,21097,1,1,827,3.8
27061,21759,20758,0,6,1001,4.6
27063,5552,5392,0,9,160,2.9
27065,9349,8879,0,8,470,5
27067,23424,22741,0,4,683,2.9
27069,2243,2175,0,9,68,3
27071,5766,5519,0,7,247,4.3
27073,3412,3318,0,9,94,2.8
27075,5302,5096,0,8,206,3.9
27077,2377,2294,0,9,83,3.5
27079,16059,15428,1,1,631,3.9
27081,3081,2988,0,9,93,3
27083,14255,13892,0,7,363,2.5
27085,19357,18732,0,4,625,3.2
27087,2298,2189,0,8,109,4.7
27089,5431,5203,0,8,228,4.2
27091,9785,9508,0,6,277,2.8
27093,13908,13470,0,6,438,3.1
27095,12817,12169,1,1,648,5.1
27097,17628,16844,0,6,784,4.4
27099,21245,20691,0,4,554,2.6
27101,4673,4491,0,9,182,3.9
27103,21015,20554,1,3,461,2.2
27105,11092,10788,0,7,304,2.7
27107,3193,3080,0,8,113,3.5
27109,91858,89894,1,3,1964,2.1
27111,31588,30552,0,6,1036,3.3
27113,8688,8404,0,6,284,3.3
27115,14643,13927,0,8,716,4.9
27117,4683,4551,0,8,132,2.8
27119,16254,15779,1,3,475,2.9
27121,6491,6310,0,8,181,2.8
27123,286615,278910,1,1,7705,2.7
27125,2163,2079,0,8,84,3.9
27127,7603,7382,0,9,221,2.9
27129,8105,7805,0,9,300,3.7
27131,37912,36932,0,4,980,2.6
27133,5964,5854,1,2,110,1.8
27135,8140,7911,0,9,229,2.8
27137,100262,97053,1,2,3209,3.2
27139,84925,82774,1,1,2151,2.5
27141,53538,51839,1,1,1699,3.2
27143,8159,7886,0,8,273,3.3
27145,90240,87723,1,3,2517,2.8
27147,19034,18464,0,5,570,3
27149,5442,5314,0,7,128,2.4
27151,4933,4779,0,9,154,3.1
27153,13786,13291,0,8,495,3.6
27155,1628,1579,0,9,49,3
27157,12317,11981,1,3,336,2.7
27159,6079,5792,0,9,287,4.7
27161,8576,8244,0,6,332,3.9
27163,145662,142110,1,1,3552,2.4
27165,6668,6477,0,8,191,2.9
27167,3417,3333,0,8,84,2.5
27169,28474,27805,0,4,669,2.3
27171,77233,74968,1,1,2265,2.9
27173,5031,4880,0,9,151,3
28000,1231104,1192015,,,39089,3.2
28001,10267,9814,0,7,453,4.4
28003,14716,14274,0,7,442,3
28005,4199,4030,0,8,169,4
28007,6759,6519,0,6,240,3.6
28009,2960,2850,1,1,110,3.7
28011,11177,10773,0,7,404,3.6
28013,5152,4979,0,9,173,3.4
28015,3059,2940,0,8,119,3.9
28017,6101,5845,0,9,256,4.2
28019,3541,3444,0,9,97,2.7
28021,2831,2623,0,8,208,7.3
28023,5428,5231,0,9,197,3.6
28025,8869,8574,0,7,295,3.3
28027,7287,6928,0,6,359,4.9
28029,10661,10283,1,2,378,3.5
28031,8118,7897,0,8,221,2.7
28033,91444,88909,1,1,2535,2.8
28035,33036,32051,1,3,985,3
28037,2636,2522,0,9,114,4.3
28039,8699,8359,0,8,340,3.9
28041,4200,4027,0,8,173,4.1
28043,8340,8044,0,7,296,3.5
28045,18797,18182,1,2,615,3.3
28047,86933,84373,1,2,2560,2.9
28049,100930,97816,1,2,3114,3.1
28051,4923,4641,1,2,282,5.7
28053,1883,1758,0,8,125,6.6
28055,293,271,0,9,22,7.5
28057,9816,9527,0,9,289,2.9
28059,58292,56388,1,2,1904,3.3
28061,5845,5627,0,8,218,3.7
28063,1793,1580,0,9,213,11.9
28065,3847,3693,0,8,154,4
28067,25002,24211,0,4,791,3.2
28069,3137,2994,0,9,143,4.6
28071,28025,27330,0,4,695,2.5
28073,31499,30725,1,3,774,2.5
28075,28114,27208,0,5,906,3.2
28077,4703,4525,0,8,178,3.8
28079,7807,7561,0,8,246,3.2
28081,39014,37928,0,5,1086,2.8
28083,8629,8208,0,6,421,4.9
28085,14388,13936,0,6,452,3.1
28087,24276,23482,0,5,794,3.3
28089,53001,51650,1,2,1351,2.5
28091,9959,9645,0,6,314,3.2
28093,13867,13369,1,1,498,3.6
28095,14548,13992,0,7,556,3.8
28097,3738,3606,0,9,132,3.5
28099,9727,9384,0,7,343,3.5
28101,7654,7379,0,8,275,3.6
28103,3303,3148,0,9,155,4.7
28105,21607,20891,0,5,716,3.3
28107,12026,11558,0,6,468,3.9
28109,23674,22956,0,6,718,3
28111,4198,4039,1,3,159,3.8
28113,13794,13248,0,6,546,4
28115,14184,13801,0,9,383,2.7
28117,10855,10554,0,7,301,2.8
28119,2226,2120,0,8,106,4.8
28121,76142,74373,1,2,1769,2.3
28123,12358,12040,1,2,318,2.6
28125,1181,1108,0,8,73,6.2
28127,10487,10172,1,2,315,3
28129,6467,6284,0,8,183,2.8
28131,6858,6624,1,2,234,3.4
28133,7360,7021,0,7,339,4.6
28135,4779,4621,0,9,158,3.3
28137,11796,11410,1,1,386,3.3
28139,9735,9466,0,8,269,2.8
28141,8062,7803,0,8,259,3.2
28143,4036,3896,1,1,140,3.5
28145,14432,14106,0,7,326,2.3
28147,4817,4620,0,9,197,4.1
28149,18859,18212,0,4,647,3.4
28151,14198,13496,0,5,702,4.9
28153,6897,6646,0,9,251,3.6
28155,3795,3679,0,9,116,3.1
28157,2522,2383,0,8,139,5.5
28159,7054,6814,0,9,240,3.4
28161,4771,4604,0,9,167,3.5
28163,8713,8415,1,2,298,3.4
29000,3087759,2993587,,,94172,3
29001,9857,9499,0,7,358,3.6
29003,9439,9194,1,3,245,2.6
29005,2421,2356,0,9,65,2.7
29007,9681,9357,0,6,324,3.3
29009,13921,13435,0,6,486,3.5
29011,5222,5064,0,8,158,3
29013,7668,7423,1,1,245,3.2
29015,7184,6875,0,9,309,4.3
29017,5278,5121,1,3,157,3
29019,101183,98678,1,3,2505,2.5
29021,42471,41251,1,3,1220,2.9
29023,17526,16760,0,5,766,4.4
29025,4252,4121,1,1,131,3.1
29027,21830,21211,1,3,619,2.8
29029,19570,18833,0,7,737,3.8
29031,40650,39535,1,3,1115,2.7
29033,4568,4440,0,8,128,2.8
29035,2414,2307,0,9,107,4.4
29037,55599,53950,1,1,1649,3
29039,5694,5495,0,8,199,3.5
29041,3648,3551,0,8,97,2.7
29043,48147,46935,1,2,1212,2.5
29045,2960,2847,0,9,113,3.8
29047,140139,136342,1,1,3797,2.7
29049,10693,10369,1,1,324,3
29051,39656,38666,1,3,990,2.5
29053,7087,6873,1,3,214,3
29055,10593,10231,0,8,362,3.4
29057,3365,3265,0,8,100,3
29059,7289,7063,1,2,226,3.1
29061,3953,3843,0,8,110,2.8
29063,4033,3918,1,3,115,2.9
29065,6232,6013,0,9,219,3.5
29067,5157,4986,0,8,171,3.3
29069,10996,10442,0,7,554,5
29071,53453,51952,1,1,1501,2.8
29073,7529,7326,0,8,203,2.7
29075,3149,3066,0,8,83,2.6
29077,157725,153698,1,2,4027,2.6
29079,3957,3833,0,7,124,3.1
29081,3646,3535,0,9,111,3
29083,10137,9823,0,6,314,3.1
29085,4162,4013,0,8,149,3.6
29087,2423,2364,0,8,59,2.4
29089,4678,4535,1,3,143,3.1
29091,16094,15502,0,7,592,3.7
29093,3435,3265,0,9,170,4.9
29095,364674,352361,1,1,12313,3.4
29097,57591,55863,1,3,1728,3
29099,119291,115930,1,1,3361,2.8
29101,23033,22282,0,4,751,3.3
29103,1662,1609,0,9,53,3.2
29105,16777,16233,0,6,544,3.2
29107,16866,16376,1,1,490,2.9
29109,17083,16555,0,6,528,3.1
29111,4724,4586,0,9,138,2.9
29113,29571,28646,1,1,925,3.1
29115,5078,4884,0,9,194,3.8
29117,7009,6842,0,7,167,2.4
29119,11336,10967,0,8,369,3.3
29121,6929,6698,0,7,231,3.3
29123,5217,5024,0,9,193,3.7
29125,3860,3735,0,8,125,3.2
29127,13698,13271,0,7,427,3.1
29129,1647,1601,0,9,46,2.8
29131,12877,12472,0,6,405,3.1
29133,5064,4873,0,8,191,3.8
29135,7106,6922,1,3,184,2.6
29137,3730,3610,0,9,120,3.2
29139,5890,5712,0,8,178,3
29141,8409,8095,0,8,314,3.7
29143,8210,7908,0,9,302,3.7
29145,27212,26389,1,3,823,3
29147,11170,10854,0,6,316,2.8
29149,3857,3721,0,9,136,3.5
29151,7092,6920,1,3,172,2.4
29153,3418,3257,0,9,161,4.7
29155,5799,5517,0,7,282,4.9
29157,9694,9450,0,6,244,2.5
29159,20079,19453,0,5,626,3.1
29161,20153,19529,0,5,624,3.1
29163,7217,6988,0,8,229,3.2
29165,60678,59116,1,1,1562,2.6
29167,14880,14421,1,2,459,3.1
29169,14619,14089,0,5,530,3.6
29171,2115,2050,0,9,65,3.1
29173,5365,5216,0,9,149,2.8
29175,10042,9690,0,6,352,3.5
29177,10956,10595,1,1,361,3.3
29179,2721,2629,0,9,92,3.4
29181,5157,4944,0,9,213,4.1
29183,231852,225944,1,1,5908,2.5
29185,3829,3685,0,8,144,3.8
29186,9390,9127,0,8,263,2.8
29187,25524,24535,0,4,989,3.9
29189,532451,516724,1,1,15727,3
29195,10422,10114,0,7,308,3
29197,1789,1720,0,9,69,3.9
29199,2295,2240,0,9,55,2.4
29201,19817,19226,0,4,591,3
29203,3285,3135,0,9,150,4.6
29205,2887,2809,0,9,78,2.7
29207,13013,12506,0,6,507,3.9
29209,13442,12817,0,6,625,4.6
29211,2486,2404,0,9,82,3.3
29213,25931,24659,0,4,1272,4.9
29215,9052,8711,0,9,341,3.8
29217,8963,8653,0,6,310,3.5
29219,18940,18385,1,1,555,2.9
29221,10019,9638,0,8,381,3.8
29223,4789,4574,0,9,215,4.5
29225,17836,17348,1,2,488,2.7
29227,1128,1100,0,9,28,2.5
29229,7664,7396,0,8,268,3.5
29510,150650,145099,1,1,5551,3.7
30000,574096,557509,,,16587,2.9
30001,5200,5073,0,9,127,2.4
30003,4590,4390,0,8,200,4.4
30005,2180,2102,0,9,78,3.6
30007,2847,2746,1,3,101,3.5
30009,5886,5724,1,3,162,2.8
30011,688,674,0,9,14,2
30013,39489,38355,1,3,1134,2.9
30015,2507,2428,0,8,79,3.2
30017,6299,6123,0,7,176,2.8
30019,874,857,0,9,17,1.9
30021,4291,4180,0,7,111,2.6
30023,5472,5321,0,7,151,2.8
30025,1637,1609,0,9,28,1.7
30027,5828,5650,0,7,178,3.1
30029,53813,51943,0,5,1870,3.5
30031,79948,78270,1,3,1678,2.1
30033,743,718,0,9,25,3.4
30035,5730,5419,0,9,311,5.4
30037,381,370,0,8,11,2.9
30039,1697,1628,0,8,69,4.1
30041,7657,7467,0,7,190,2.5
30043,6125,5947,1,3,178,2.9
30045,972,945,0,8,27,2.8
30047,14309,13795,0,6,514,3.6
30049,38712,37712,1,3,1000,2.6
30051,1010,985,0,9,25,2.5
30053,8696,8240,0,9,456,5.2
30055,985,965,0,9,20,2
30057,4543,4405,0,8,138,3
30059,1012,986,0,8,26,2.6
30061,1880,1787,1,3,93,4.9
30063,69185,67213,1,3,1972,2.9
30065,2390,2317,0,8,73,3.1
30067,10268,9975,0,6,293,2.9
30069,276,267,0,9,9,3.3
30071,1761,1687,0,9,74,4.2
30073,2657,2581,0,9,76,2.9
30075,1018,993,0,9,25,2.5
30077,2999,2909,0,8,90,3
30079,674,657,0,9,17,2.5
30081,22245,21566,0,6,679,3.1
30083,5662,5513,0,7,149,2.6
30085,4270,4106,0,9,164,3.8
30087,3570,3448,0,8,122,3.4
30089,5517,5251,0,8,266,4.8
30091,1724,1685,0,9,39,2.3
30093,18005,17399,0,5,606,3.4
30095,5389,5259,1,3,130,2.4
30097,1909,1865,0,8,44,2.3
30099,2789,2707,0,8,82,2.9
30101,2089,2044,0,9,45,2.2
30103,339,330,0,8,9,2.7
30105,3962,3864,0,9,98,2.5
30107,755,725,0,9,30,4
30109,437,425,0,9,12,2.7
30111,88210,85913,1,3,2297,2.6
31000,1054681,1030880,,,23801,2.3
31001,17177,16819,0,4,358,2.1
31003,3515,3448,0,9,67,1.9
31005,218,212,0,9,6,2.8
31007,383,372,0,8,11,2.9
31009,247,238,0,9,9,3.6
31011,2958,2909,0,9,49,1.7
31013,5273,5159,0,7,114,2.2
31015,1009,985,0,9,24,2.4
31017,1381,1346,0,9,35,2.5
31019,28583,28056,0,4,527,1.8
31021,3545,3457,0,8,88,2.5
31023,4645,4567,0,8,78,1.7
31025,13646,13329,1,2,317,2.3
31027,4630,4547,0,9,83,1.8
31029,2227,2190,0,9,37,1.7
31031,3312,3250,0,9,62,1.9
31033,4103,4004,0,7,99,2.4
31035,3061,2987,0,9,74,2.4
31037,5831,5726,0,7,105,1.8
31039,4800,4710,0,9,90,1.9
31041,6288,6180,0,9,108,1.7
31043,10965,10673,1,3,292,2.7
31045,4977,4877,0,9,100,2
31047,13554,13231,0,7,323,2.4
31049,952,927,0,9,25,2.6
31051,2997,2937,0,8,60,2
31053,20771,20316,0,4,455,2.2
31055,306276,298425,1,2,7851,2.6
31057,1172,1152,0,9,20,1.7
31059,3307,3244,0,8,63,1.9
31061,1512,1480,0,9,32,2.1
31063,1517,1486,0,9,31,2
31065,2474,2428,0,9,46,1.9
31067,10861,10580,0,6,281,2.6
31069,1080,1058,0,9,22,2
31071,1113,1091,0,9,22,2
31073,1159,1134,0,9,25,2.2
31075,401,395,0,9,6,1.5
31077,1203,1179,0,8,24,2
31079,33433,32658,1,3,775,2.3
31081,4965,4869,0,8,96,1.9
31083,1750,1717,0,9,33,1.9
31085,580,571,0,9,9,1.6
31087,1276,1242,0,9,34,2.7
31089,5614,5514,0,9,100,1.8
31091,356,347,0,9,9,2.5
31093,3524,3457,1,3,67,1.9
31095,4175,4093,0,9,82,2
31097,1984,1922,0,8,62,3.1
31099,3713,3649,0,9,64,1.7
31101,4601,4516,0,9,85,1.8
31103,550,538,0,9,12,2.2
31105,1932,1893,0,8,39,2
31107,4545,4447,0,9,98,2.2
31109,181811,177964,1,2,3847,2.1
31111,18373,17976,0,5,397,2.2
31113,451,440,0,9,11,2.4
31115,383,372,0,9,11,2.9
31117,426,417,0,9,9,2.1
31119,20014,19610,0,5,404,2
31121,4239,4156,1,3,83,2
31123,2648,2591,0,9,57,2.2
31125,1958,1916,0,8,42,2.1
31127,3560,3480,0,9,80,2.2
31129,2461,2411,0,9,50,2
31131,8403,8222,0,6,181,2.2
31133,1479,1449,0,9,30,2
31135,1808,1778,0,9,30,1.7
31137,5077,4986,0,7,91,1.8
31139,4207,4130,0,9,77,1.8
31141,18381,18020,0,5,361,2
31143,2885,2829,0,8,56,1.9
31145,5880,5767,0,7,113,1.9
31147,4029,3944,0,9,85,2.1
31149,864,851,0,9,13,1.5
31151,7152,6977,0,6,175,2.4
31153,99872,97675,1,2,2197,2.2
31155,11492,11272,1,2,220,1.9
31157,17990,17517,0,5,473,2.6
31159,8899,8719,1,2,180,2
31161,2721,2666,0,9,55,2
31163,1651,1615,0,8,36,2.2
31165,760,744,0,9,16,2.1
31167,3517,3450,0,9,67,1.9
31169,2690,2641,0,9,49,1.8
31171,416,402,0,9,14,3.4
31173,3273,3184,0,8,89,2.7
31175,2068,2023,0,9,45,2.2
31177,11482,11236,1,2,246,2.1
31179,5720,5605,0,7,115,2
31181,1661,1619,0,9,42,2.5
31183,533,524,0,9,9,1.7
31185,7335,7171,0,6,164,2.2
32000,1602652,1520260,,,82392,5.1
32001,11077,10605,0,6,472,4.3
32003,1186493,1122046,1,1,64447,5.4
32005,22657,21628,0,4,1029,4.5
32007,25920,24940,0,5,980,3.8
32009,479,460,0,9,19,4
32011,995,958,0,9,37,3.7
32013,7807,7503,0,7,304,3.9
32015,3151,3038,0,9,113,3.6
32017,2028,1933,0,8,95,4.7
32019,23627,22259,1,2,1368,5.8
32021,1507,1404,0,8,103,6.8
32023,18281,17109,0,4,1172,6.4
32027,2377,2266,0,8,111,4.7
32029,2141,2049,1,2,92,4.3
32031,263489,252761,1,2,10728,4.1
32033,4605,4450,0,9,155,3.4
32510,26018,24850,1,3,1168,4.5
33000,759604,742886,,,16718,2.2
33001,30978,30315,0,4,663,2.1
33003,23024,22502,0,6,522,2.3
33005,38817,37915,0,4,902,2.3
33007,14215,13839,0,7,376,2.6
33009,48303,47365,0,5,938,1.9
33011,239121,233610,1,2,5511,2.3
33013,82275,80709,0,4,1566,1.9
33015,187453,183134,1,1,4319,2.3
33017,72663,71171,1,1,1492,2.1
33019,22756,22328,0,7,428,1.9
34000,4829671,4615722,,,213949,4.4
34001,124235,116946,1,2,7289,5.9
34003,514345,494480,1,1,19865,3.9
34005,252255,242294,1,1,9961,3.9
34007,276187,262852,1,1,13335,4.8
34009,48535,44835,1,2,3700,7.6
34011,69962,65428,1,3,4534,6.5
34013,397420,375401,1,1,22019,5.5
34015,164258,157191,1,1,7067,4.3
34017,385860,368978,1,1,16882,4.4
34019,69322,66902,1,1,2420,3.5
34021,218979,210460,1,2,8519,3.9
34023,470487,451218,1,1,19269,4.1
34025,352981,339416,1,1,13565,3.8
34027,273903,263900,1,1,10003,3.7
34029,302654,289839,1,1,12815,4.2
34031,259188,244903,1,1,14285,5.5
34033,31419,29692,1,1,1727,5.5
34035,182817,175899,1,1,6918,3.8
34037,79040,75673,1,1,3367,4.3
34039,295774,281793,1,1,13981,4.7
34041,60052,57624,1,2,2428,4
35000,965244,928983,,,36261,3.8
35001,344824,332910,1,2,11914,3.5
35003,1129,1074,0,9,55,4.9
35005,27309,26268,0,5,1041,3.8
35006,8151,7728,0,6,423,5.2
35007,5364,5179,0,7,185,3.4
35009,22257,21611,0,5,646,2.9
35011,724,700,0,9,24,3.3
35013,102153,97763,1,3,4390,4.3
35015,32215,31365,0,5,850,2.6
35017,11712,11301,0,7,411,3.5
35019,1507,1446,0,9,61,4
35021,270,260,0,9,10,3.7
35023,1763,1705,0,9,58,3.3
35025,30194,29139,0,5,1055,3.5
35027,9073,8781,0,7,292,3.2
35028,11817,11598,0,6,219,1.9
35029,10089,9077,0,6,1012,10
35031,22694,21518,0,5,1176,5.2
35033,1916,1821,0,8,95,5
35035,24973,23970,0,4,1003,4
35037,2960,2837,0,7,123,4.2
35039,16926,16343,0,6,583,3.4
35041,7855,7569,0,7,286,3.6
35043,69535,67001,1,2,2534,3.6
35045,50865,48740,1,3,2125,4.2
35047,10519,10031,0,6,488,4.6
35049,72966,70517,1,3,2449,3.4
35051,3877,3645,0,6,232,6
35053,6170,5910,0,6,260,4.2
35055,14808,14154,0,7,654,4.4
35057,5499,5220,1,2,279,5.1
35059,1531,1483,0,9,48,3.1
35061,31599,30319,1,2,1280,4.1
36000,9717791,9306973,,,410818,4.2
36001,160625,155345,1,2,5280,3.3
36003,19399,18571,0,7,828,4.3
36005,607911,566410,1,1,41501,6.8
36007,82921,79656,1,3,3265,3.9
36009,33096,31684,0,4,1412,4.3
36011,35666,34380,0,4,1286,3.6
36013,53218,50944,0,4,2274,4.3
36015,34619,33235,1,3,1384,4
36017,21972,21208,0,6,764,3.5
36019,35806,34546,0,4,1260,3.5
36021,30670,29755,0,6,915,3
36023,22426,21473,0,4,953,4.2
36025,18669,17916,0,8,753,4
36027,147036,142236,1,2,4800,3.3
36029,449836,432741,1,1,17095,3.8
36031,17020,16371,0,6,649,3.8
36033,19106,18377,0,7,729,3.8
36035,22577,21591,0,4,986,4.4
36037,29789,28808,0,4,981,3.3
36039,20525,19739,0,6,786,3.8
36041,2242,2130,0,8,112,5
36043,27470,26351,1,2,1119,4.1
36045,44317,42388,1,3,1929,4.4
36047,1225540,1157820,1,1,67720,5.5
36049,11848,11329,0,8,519,4.4
36051,30440,29370,1,1,1070,3.5
36053,32927,31701,1,2,1226,3.7
36055,366441,353007,1,1,13434,3.7
36057,22297,21272,0,4,1025,4.6
36059,737126,714122,1,1,23004,3.1
36061,935314,892343,1,1,42971,4.6
36063,99338,95298,1,1,4040,4.1
36065,100528,96796,1,2,3732,3.7
36067,224014,216184,1,2,7830,3.5
36069,56104,54262,1,1,1842,3.3
36071,193668,187010,1,2,6658,3.4
36073,17233,16549,1,1,684,4
36075,52899,50619,1,2,2280,4.3
36077,26954,25920,0,7,1034,3.8
36079,52179,50548,1,1,1631,3.1
36081,1153534,1100437,1,1,53097,4.6
36083,82853,80116,1,2,2737,3.3
36085,229578,218372,1,1,11206,4.9
36087,162073,157018,1,1,5055,3.1
36089,43114,41229,0,4,1885,4.4
36091,122572,119039,1,2,3533,2.9
36093,78483,75729,1,2,2754,3.5
36095,14943,14322,1,2,621,4.2
36097,8142,7823,0,8,319,3.9
36099,14624,14114,0,6,510,3.5
36101,41209,39573,0,4,1636,4
36103,809422,781979,1,1,27443,3.4
36105,38640,37358,0,6,1282,3.3
36107,22428,21669,1,3,759,3.4
36109,49344,47801,1,3,1543,3.1
36111,88606,85552,1,3,3054,3.4
36113,31463,30304,1,3,1159,3.7
36115,27688,26747,1,3,941,3.4
36117,43611,42145,1,1,1466,3.4
36119,504732,487720,1,1,17012,3.4
36121,17253,16576,0,8,677,3.9
36123,11719,11349,0,6,370,3.2
37000,5231638,5050870,,,180768,3.5
37001,85834,82920,1,3,2914,3.4
37003,18013,17433,1,2,580,3.2
37005,4266,4075,0,9,191,4.5
37007,10263,9849,1,1,414,4
37009,12820,12435,0,9,385,3
37011,7798,7562,0,9,236,3
37013,19376,18592,0,6,784,4
37015,7037,6729,0,9,308,4.4
37017,14513,13900,0,8,613,4.2
37019,59130,56643,1,2,2487,4.2
37021,144131,140230,1,2,3901,2.7
37023,40790,39452,1,2,1338,3.3
37025,118475,114631,1,1,3844,3.2
37027,36321,35092,1,2,1229,3.4
37029,4765,4610,1,1,155,3.3
37031,32691,31631,0,4,1060,3.2
37033,9825,9476,0,8,349,3.6
37035,79367,76755,1,2,2612,3.3
37037,38077,36951,1,2,1126,3
37039,10968,10544,0,9,424,3.9
37041,5916,5703,0,8,213,3.6
37043,4205,4049,0,9,156,3.7
37045,49621,47901,0,4,1720,3.5
37047,22330,21438,0,6,892,4
37049,42784,41301,0,4,1483,3.5
37051,129432,123330,1,2,6102,4.7
37053,14881,14426,1,1,455,3.1
37055,20255,19454,0,4,801,4
37057,81401,78659,1,2,2742,3.4
37059,20731,20080,1,2,651,3.1
37061,25522,24676,0,8,846,3.3
37063,182531,176950,1,2,5581,3.1
37065,20046,18897,1,3,1149,5.7
37067,188507,181846,1,2,6661,3.5
37069,34905,33688,1,1,1217,3.5
37071,116898,112933,1,1,3965,3.4
37073,5203,5029,1,1,174,3.3
37075,2940,2812,0,9,128,4.4
37077,30481,29552,0,6,929,3
37079,9652,9373,0,8,279,2.9
37081,260038,249860,1,2,10178,3.9
37083,19274,18276,0,4,998,5.2
37085,55643,53470,0,4,2173,3.9
37087,30680,29756,0,4,924,3
37089,56343,54705,1,2,1638,2.9
37091,8415,8022,0,8,393,4.7
37093,20525,19614,1,2,911,4.4
37095,1774,1671,0,9,103,5.8
37097,96551,93417,1,1,3134,3.2
37099,20030,19310,0,7,720,3.6
37101,110895,107369,1,1,3526,3.2
37103,4370,4232,0,8,138,3.2
37105,25704,24680,0,4,1024,4
37107,27780,26826,0,4,954,3.4
37109,47301,45881,1,1,1420,3
37111,20276,19623,0,6,653,3.2
37113,16490,15968,0,7,522,3.2
37115,10232,9908,1,2,324,3.2
37117,8646,8269,0,6,377,4.4
37119,665695,643343,1,1,22352,3.4
37121,6187,5963,0,8,224,3.6
37123,11229,10822,0,8,407,3.6
37125,43036,41555,1,3,1481,3.4
37127,42055,40141,1,3,1914,4.6
37129,132975,128796,1,2,4179,3.1
37131,7268,6934,0,9,334,4.6
37133,69558,66767,1,3,2791,4
37135,83045,80644,1,2,2401,2.9
37137,5580,5398,0,9,182,3.3
37139,17067,16375,0,4,692,4.1
37141,31484,30478,1,2,1006,3.2
37143,5048,4846,0,8,202,4
37145,19150,18482,1,2,668,3.5
37147,89299,85787,1,3,3512,3.9
37149,9469,9158,0,8,311,3.3
37151,65385,63027,1,2,2358,3.6
37153,17062,16283,0,4,779,4.6
37155,48220,45824,0,4,2396,5
37157,39442,37876,1,2,1566,4
37159,69023,66688,1,1,2335,3.4
37161,24392,23267,0,4,1125,4.6
37163,27978,26985,0,6,993,3.5
37165,11226,10518,0,6,708,6.3
37167,32089,31119,0,6,970,3
37169,21613,20942,1,2,671,3.1
37171,33283,32228,0,6,1055,3.2
37173,7119,6910,0,9,209,2.9
37175,14903,14422,0,6,481,3.2
37177,1325,1258,0,9,67,5.1
37179,132893,128911,1,1,3982,3
37181,16752,15850,0,6,902,5.4
37183,648814,629344,1,1,19470,3
37185,6294,5956,0,8,338,5.4
37187,4321,4114,0,9,207,4.8
37189,29969,29070,0,5,899,3
37191,51478,49551,1,3,1927,3.7
37193,26333,25352,0,6,981,3.7
37195,33942,32264,0,4,1678,4.9
37197,17608,17054,1,2,554,3.1
37199,8371,8110,0,8,261,3.1
38000,416722,408909,,,7813,1.9
38001,952,935,0,9,17,1.8
38003,5200,5090,0,6,110,2.1
38005,2305,2243,0,9,62,2.7
38007,465,457,0,9,8,1.7
38009,3007,2936,0,8,71,2.4
38011,1552,1532,0,9,20,1.3
38013,1068,1051,0,8,17,1.6
38015,51943,51034,1,3,909,1.7
38017,111299,109423,1,3,1876,1.7
38019,1837,1796,0,9,41,2.2
38021,2258,2220,0,9,38,1.7
38023,1546,1528,0,9,18,1.2
38025,3163,3127,0,9,36,1.1
38027,1178,1147,0,9,31,2.6
38029,1472,1411,0,8,61,4.1
38031,1519,1491,0,9,28,1.8
38033,864,850,0,9,14,1.6
38035,37962,37310,1,3,652,1.7
38037,1237,1217,0,8,20,1.6
38039,1027,1007,0,9,20,1.9
38041,1350,1328,0,9,22,1.6
38043,1333,1291,0,8,42,3.2
38045,2104,2066,0,9,38,1.8
38047,857,837,0,9,20,2.3
38049,3138,3050,1,3,88,2.8
38051,1073,1053,0,9,20,1.9
38053,9803,9679,0,7,124,1.3
38055,4753,4638,0,8,115,2.4
38057,3661,3567,0,8,94,2.6
38059,17126,16728,1,3,398,2.3
38061,6596,6515,0,8,81,1.2
38063,1448,1412,0,8,36,2.5
38065,883,856,1,3,27,3.1
38067,3238,3147,0,9,91,2.8
38069,1702,1659,0,9,43,2.5
38071,5655,5539,0,7,116,2.1
38073,2620,2580,0,8,40,1.5
38075,1232,1211,1,3,21,1.7
38077,8893,8743,0,6,150,1.7
38079,4734,4473,0,9,261,5.5
38081,2246,2212,0,9,34,1.5
38083,650,633,0,8,17,2.6
38085,1221,1192,0,9,29,2.4
38087,339,331,0,9,8,2.4
38089,18628,18342,0,5,286,1.5
38091,947,928,0,8,19,2
38093,10762,10566,0,7,196,1.8
38095,1149,1126,0,9,23,2
38097,4564,4487,0,8,77,1.7
38099,5199,5047,0,8,152,2.9
38101,32207,31534,1,3,673,2.1
38103,1917,1864,0,9,53,2.8
38105,22847,22471,0,5,376,1.6
39000,5786996,5582438,,,204558,3.5
39001,11111,10550,0,8,561,5
39003,46896,45151,1,3,1745,3.7
39005,25732,24848,0,6,884,3.4
39007,42855,41154,1,1,1701,4
39009,25976,24824,0,4,1152,4.4
39011,24652,24003,0,4,649,2.6
39013,27716,26508,1,3,1208,4.4
39015,19666,18864,1,1,802,4.1
39017,199441,193048,1,1,6393,3.2
39019,12588,12096,1,2,492,3.9
39021,19487,18867,0,6,620,3.2
39023,63224,60944,1,3,2280,3.6
39025,109258,105774,1,1,3484,3.2
39027,18147,17427,0,6,720,4
39029,44985,43100,0,4,1885,4.2
39031,13852,13234,0,7,618,4.5
39033,17753,16996,0,4,757,4.3
39035,605553,582260,1,1,23293,3.8
39037,25758,24953,0,6,805,3.1
39039,17573,16964,0,6,609,3.5
39041,116479,113218,1,1,3261,2.8
39043,36380,34780,1,3,1600,4.4
39045,80859,78328,1,1,2531,3.1
39047,13741,13247,0,6,494,3.6
39049,714097,691659,1,1,22438,3.1
39051,21852,21080,1,2,772,3.5
39053,12195,11670,0,6,525,4.3
39055,48777,47243,1,1,1534,3.1
39057,82404,79747,1,2,2657,3.2
39059,17865,17089,0,6,776,4.3
39061,422180,408524,1,1,13656,3.2
39063,40035,38883,0,4,1152,2.9
39065,12959,12472,0,6,487,3.8
39067,6637,6364,0,8,273,4.1
39069,12903,12363,0,6,540,4.2
39071,17452,16657,0,6,795,4.6
39073,13027,12546,1,1,481,3.7
39075,21789,21172,0,9,617,2.8
39077,27808,26562,0,4,1246,4.5
39079,12566,11992,0,7,574,4.6
39081,26773,25408,1,3,1365,5.1
39083,31310,30288,0,6,1022,3.3
39085,126021,121793,1,1,4228,3.4
39087,23518,22554,1,2,964,4.1
39089,92612,89744,1,1,2868,3.1
39091,22831,22139,0,4,692,3
39093,155146,149247,1,1,5899,3.8
39095,205391,196795,1,2,8596,4.2
39097,21162,20537,1,1,625,3
39099,98452,94271,1,2,4181,4.2
39101,26987,26061,0,4,926,3.4
39103,98751,95667,1,1,3084,3.1
39105,8599,8136,0,8,463,5.4
39107,23062,22543,0,7,519,2.3
39109,53608,51881,1,2,1727,3.2
39111,5186,4900,0,8,286,5.5
39113,246649,237282,1,2,9367,3.8
39115,6872,6566,0,8,306,4.5
39117,17118,16519,1,1,599,3.5
39119,41280,39718,0,4,1562,3.8
39121,4584,4359,0,9,225,4.9
39123,20790,19796,1,3,994,4.8
39125,8781,8512,0,8,269,3.1
39127,16076,15429,1,1,647,4
39129,26989,26098,1,1,891,3.3
39131,11214,10693,0,9,521,4.6
39133,86020,83050,1,2,2970,3.5
39135,21683,21015,0,6,668,3.1
39137,18892,18395,0,6,497,2.6
39139,50601,48502,1,3,2099,4.1
39141,35444,34246,0,4,1198,3.4
39143,29963,28904,0,4,1059,3.5
39145,29584,28163,0,4,1421,4.8
39147,26461,25512,0,4,949,3.6
39149,23672,22928,0,4,744,3.1
39151,180968,174311,1,2,6657,3.7
39153,267894,258006,1,2,9888,3.7
39155,83114,79479,1,2,3635,4.4
39157,44851,43247,0,4,1604,3.6
39159,30437,29589,1,1,848,2.8
39161,14634,14220,0,6,414,2.8
39163,5440,5181,0,8,259,4.8
39165,124076,120341,1,1,3735,3
39167,26869,25729,0,4,1140,4.2
39169,60740,59030,0,4,1710,2.8
39171,18167,17595,0,7,572,3.1
39173,70080,67823,1,2,2257,3.2
39175,13429,13079,0,7,350,2.6
4000,3690974,3546508,,,144466,3.9
40000,1963240,1899949,,,63291,3.2
40001,8798,8467,0,8,331,3.8
40003,2748,2675,0,8,73,2.7
40005,5214,5018,0,9,196,3.8
40007,2793,2734,0,9,59,2.1
40009,10767,10448,0,7,319,3
4001,18283,16842,0,8,1441,7.9
40011,4403,4303,0,8,100,2.3
40013,24414,23695,0,6,719,2.9
40015,12093,11687,0,6,406,3.4
40017,84372,82063,1,1,2309,2.7
40019,22296,21476,0,5,820,3.7
40021,21011,20271,0,6,740,3.5
40023,6878,6609,0,9,269,3.9
40025,1414,1386,0,9,28,2
40027,155542,151209,1,1,4333,2.8
40029,2397,2300,0,9,97,4
4003,49585,47337,1,3,2248,4.5
40031,48770,46860,1,3,1910,3.9
40033,2748,2664,1,3,84,3.1
40035,5945,5742,0,6,203,3.4
40037,32804,31682,1,1,1122,3.4
40039,15445,15020,0,5,425,2.8
40041,20366,19688,0,6,678,3.3
40043,3222,3156,0,9,66,2
40045,2128,2078,0,9,50,2.3
40047,26749,25889,1,3,860,3.2
40049,13127,12723,0,6,404,3.1
4005,75192,72034,1,3,3158,4.2
40051,28633,27796,1,1,837,2.9
40053,2898,2839,0,8,59,2
40055,1923,1849,0,9,74,3.8
40057,1243,1211,0,9,32,2.6
40059,1882,1838,0,9,44,2.3
40061,4471,4257,0,8,214,4.8
40063,5321,5109,0,9,212,4
40065,11172,10843,0,7,329,2.9
40067,2549,2458,0,8,91,3.6
40069,4204,4043,0,9,161,3.8
4007,20652,19763,0,4,889,4.3
40071,18526,17861,0,4,665,3.6
40073,9288,9079,0,8,209,2.3
40075,3750,3615,0,8,135,3.6
40077,3940,3753,0,9,187,4.7
40079,20183,19371,0,6,812,4
40081,16955,16409,1,1,546,3.2
40083,24520,23769,1,1,751,3.1
40085,6198,6029,0,9,169,2.7
40087,21908,21279,1,1,629,2.9
40089,16462,15778,0,7,684,4.2
4009,16670,16056,0,7,614,3.7
40091,7508,7099,0,8,409,5.4
40093,3873,3771,0,8,102,2.6
40095,7778,7526,0,9,252,3.2
40097,20564,19897,0,6,667,3.2
40099,5903,5703,0,9,200,3.4
40101,28618,27497,0,4,1121,3.9
40103,5981,5824,0,8,157,2.6
40105,4790,4645,0,8,145,3
40107,4665,4472,0,8,193,4.1
40109,417327,404156,1,1,13171,3.2
4011,4722,4587,0,9,135,2.9
40111,16285,15601,1,1,684,4.2
40113,21473,20684,1,1,789,3.7
40115,15393,14925,0,6,468,3
40117,7677,7407,1,1,270,3.5
40119,40757,39533,0,4,1224,3
4012,9093,8660,0,6,433,4.8
40121,16759,16002,0,7,757,4.5
40123,19992,19374,0,7,618,3.1
40125,34153,32918,0,4,1235,3.6
40127,4718,4533,0,9,185,3.9
40129,1854,1810,0,9,44,2.4
4013,2441028,2357541,1,1,83487,3.4
40131,47584,46181,1,1,1403,2.9
40133,9743,9280,0,7,463,4.8
40135,17329,16690,1,3,639,3.7
40137,19980,19272,0,4,708,3.5
40139,12299,12043,0,7,256,2.1
40141,2972,2833,0,8,139,4.7
40143,341418,330507,1,1,10911,3.2
40145,40998,39678,1,1,1320,3.2
40147,23307,22516,0,4,791,3.4
40149,5393,5224,0,9,169,3.1
4015,90082,86020,1,3,4062,4.5
40151,4644,4554,0,7,90,1.9
40153,9041,8769,0,7,272,3
4017,40101,37829,0,4,2272,5.7
4019,494336,475422,1,1,18914,3.8
4021,204252,195853,1,1,8399,4.1
4023,19216,17760,0,6,1456,7.6
4025,109164,105223,1,3,3941,3.6
4027,98597,85581,1,3,13016,13.2
41000,2162127,2081652,,,80475,3.7
41001,7083,6775,0,7,308,4.3
41003,49345,47861,1,3,1484,3
41005,225075,217509,1,1,7566,3.4
41007,19668,18946,0,4,722,3.7
41009,24967,23874,1,1,1093,4.4
41011,26663,25457,0,5,1206,4.5
41013,11175,10556,1,3,619,5.5
41015,9030,8611,0,7,419,4.6
41017,104662,100812,1,3,3850,3.7
41019,46962,44756,0,4,2206,4.7
41021,939,900,0,9,39,4.2
41023,3184,3024,0,9,160,5
41025,3624,3472,0,9,152,4.2
41027,14178,13759,0,6,419,3
41029,105402,100828,1,3,4574,4.3
41031,10286,9814,1,3,472,4.6
41033,35732,33923,1,3,1809,5.1
41035,29952,28398,0,5,1554,5.2
41037,3605,3425,0,9,180,5
41039,182141,174945,1,2,7196,4
41041,21205,20305,0,5,900,4.2
41043,60545,58081,1,3,2464,4.1
41045,12844,12374,0,6,470,3.7
41047,169991,163655,1,2,6336,3.7
41049,6099,5891,0,8,208,3.4
41051,465029,448461,1,1,16568,3.6
41053,42696,41094,1,2,1602,3.8
41055,967,930,0,9,37,3.8
41057,12166,11708,0,7,458,3.8
41059,38603,37029,0,4,1574,4.1
41061,12063,11589,0,7,474,3.9
41063,3585,3426,0,9,159,4.4
41065,13174,12645,0,7,529,4
41067,332643,321932,1,1,10711,3.2
41069,798,776,0,9,22,2.8
41071,56047,54113,1,1,1934,3.5
42000,6518343,6295653,,,222690,3.4
42001,55049,53619,1,3,1430,2.6
42003,632239,611346,1,1,20893,3.3
42005,31079,29858,1,1,1221,3.9
42007,81676,78350,1,1,3326,4.1
42009,24620,23756,0,8,864,3.5
42011,215039,207558,1,2,7481,3.5
42013,59022,57058,1,3,1964,3.3
42015,28583,27647,0,6,936,3.3
42017,353140,342521,1,1,10619,3
42019,98706,95635,1,1,3071,3.1
42021,55335,53046,1,3,2289,4.1
42023,1904,1808,0,9,96,5
42025,32782,31513,1,2,1269,3.9
42027,79907,77746,1,3,2161,2.7
42029,298501,290825,1,1,7676,2.6
42031,16015,15350,0,6,665,4.2
42033,35268,33884,0,4,1384,3.9
42035,17354,16654,0,6,700,4
42037,34443,33199,0,4,1244,3.6
42039,37838,36448,0,4,1390,3.7
42041,136651,132991,1,2,3660,2.7
42043,147746,143006,1,2,4740,3.2
42045,301607,292015,1,1,9592,3.2
42047,14514,14031,0,7,483,3.3
42049,126496,121633,1,2,4863,3.8
42051,54806,52315,1,1,2491,4.5
42053,1715,1625,0,9,90,5.2
42055,77172,74942,1,3,2230,2.9
42057,7353,7126,0,8,227,3.1
42059,15626,15049,0,6,577,3.7
42061,19410,18571,0,6,839,4.3
42063,36715,35227,0,4,1488,4.1
42065,19421,18677,0,7,744,3.8
42067,12638,12206,0,8,432,3.4
42069,105523,101571,1,2,3952,3.7
42071,291261,283369,1,2,7892,2.7
42073,39162,37512,1,1,1650,4.2
42075,75170,73041,1,3,2129,2.8
42077,199532,192257,1,2,7275,3.6
42079,158844,151947,1,2,6897,4.3
42081,55485,53521,1,3,1964,3.5
42083,16704,15976,0,7,728,4.4
42085,47803,45998,0,4,1805,3.8
42087,21289,20552,0,4,737,3.5
42089,82516,78822,0,4,3694,4.5
42091,470309,457292,1,1,13017,2.8
42093,9383,9131,0,6,252,2.7
42095,166162,160416,1,2,5746,3.5
42097,42698,41009,0,4,1689,4
42099,25022,24306,1,2,716,2.9
42101,742808,711377,1,1,31431,4.2
42103,25951,24751,0,6,1200,4.6
42105,6849,6523,0,9,326,4.8
42107,66134,63477,0,4,2657,4
42109,19830,19157,0,7,673,3.4
42111,32542,31254,0,6,1288,4
42113,2587,2486,0,8,101,3.9
42115,20470,19809,0,8,661,3.2
42117,18772,18050,0,8,722,3.8
42119,19886,19318,0,6,568,2.9
42121,21007,20118,0,4,889,4.2
42123,17434,16788,0,6,646,3.7
42125,104575,100979,1,1,3596,3.4
42127,22898,22009,0,6,889,3.9
42129,175548,169433,1,1,6115,3.5
42131,13563,13065,1,2,498,3.7
42133,240265,233107,1,2,7158,3
44000,573848,556609,,,17239,3
44001,26730,26055,1,1,675,2.5
44003,94241,91699,1,1,2542,2.7
44005,45403,44211,1,1,1192,2.6
44007,336591,325520,1,1,11071,3.3
44009,70883,69124,1,1,1759,2.5
45000,2453060,2380392,,,72668,3
45001,9565,9214,0,6,351,3.7
45003,74151,71936,1,2,2215,3
45005,2323,2200,0,8,123,5.3
45007,94227,91622,1,2,2605,2.8
45009,4585,4341,0,9,244,5.3
45011,7660,7328,0,8,332,4.3
45013,79850,77626,1,3,2224,2.8
45015,115330,112230,1,2,3100,2.7
45017,6600,6385,1,2,215,3.3
45019,226376,220866,1,2,5510,2.4
45021,23381,22401,0,6,980,4.2
45023,13740,13199,1,1,541,3.9
45025,21385,20699,0,6,686,3.2
45027,12128,11646,0,8,482,4
45029,16326,15819,0,6,507,3.1
45031,30455,29458,1,3,997,3.3
45033,13042,12471,0,6,571,4.4
45035,83627,81492,1,2,2135,2.6
45037,10387,10067,1,2,320,3.1
45039,9453,9076,1,2,377,4
45041,67625,65616,1,3,2009,3
45043,26509,25647,0,4,862,3.3
45045,268077,260980,1,2,7097,2.6
45047,30030,28972,0,4,1058,3.5
45049,8112,7885,0,8,227,2.8
45051,158224,152818,1,2,5406,3.4
45053,13752,13389,1,3,363,2.6
45055,30234,29337,1,2,897,3
45057,44903,43430,1,1,1473,3.3
45059,30993,30015,1,2,978,3.2
45061,6527,6272,0,8,255,3.9
45063,155871,152047,1,2,3824,2.5
45065,3464,3349,0,8,115,3.3
45067,12733,12167,0,6,566,4.4
45069,7499,6960,0,6,539,7.2
45071,19032,18483,0,6,549,2.9
45073,35721,34733,0,4,988,2.8
45075,33392,31917,0,4,1475,4.4
45077,59768,58027,1,2,1741,2.9
45079,203246,197182,1,2,6064,3
45081,8638,8393,1,2,245,2.8
45083,158371,153786,1,2,4585,2.9
45085,41212,39629,1,3,1583,3.8
45087,11455,10989,1,2,466,4.1
45089,10405,9909,0,6,496,4.8
45091,152682,148386,1,1,4296,2.8
46000,480238,470715,,,9523,2
46003,1501,1477,0,9,24,1.6
46005,9242,9072,0,7,170,1.8
46007,1072,1039,0,9,33,3.1
46009,2873,2818,0,9,55,1.9
46011,19313,18930,0,5,383,2
46013,20079,19678,0,5,401,2
46015,2621,2576,0,9,45,1.7
46017,701,670,0,9,31,4.4
46019,5282,5181,0,7,101,1.9
46021,773,754,0,9,19,2.5
46023,3914,3828,0,9,86,2.2
46025,2109,2066,0,9,43,2
46027,7296,7145,0,6,151,2.1
46029,16164,15872,0,5,292,1.8
46031,1286,1247,0,9,39,3
46033,4252,4145,1,3,107,2.5
46035,11097,10906,0,7,191,1.7
46037,2659,2587,0,9,72,2.7
46039,2321,2257,0,9,64,2.8
46041,2296,2166,0,9,130,5.7
46043,1492,1463,0,9,29,1.9
46045,2010,1969,0,9,41,2
46047,3003,2926,0,9,77,2.6
46049,1099,1079,0,9,20,1.8
46051,4458,4349,0,9,109,2.4
46053,2121,2081,0,9,40,1.9
46055,1081,1062,0,9,19,1.8
46057,3687,3622,0,9,65,1.8
46059,1821,1792,0,9,29,1.6
46061,1792,1752,0,8,40,2.2
46063,727,713,0,9,14,1.9
46065,10023,9867,0,7,156,1.6
46067,3677,3601,0,8,76,2.1
46069,655,643,0,9,12,1.8
46071,1262,1221,0,9,41,3.2
46073,1196,1176,0,9,20,1.7
46075,523,510,0,9,13,2.5
46077,2756,2704,0,9,52,1.9
46079,6737,6609,0,6,128,1.9
46081,14551,14280,0,6,271,1.9
46083,38228,37614,1,2,614,1.6
46085,1710,1662,0,9,48,2.8
46087,3172,3118,1,2,54,1.7
46089,987,963,0,9,24,2.4
46091,2484,2421,0,9,63,2.5
46093,14617,14317,1,3,300,2.1
46095,757,733,0,9,24,3.2
46097,1280,1258,0,8,22,1.7
46099,118749,116581,1,2,2168,1.8
46101,4067,3985,0,8,82,2
46102,3593,3383,0,9,210,5.8
46103,60198,59051,1,3,1147,1.9
46105,1430,1401,0,9,29,2
46107,1059,1034,0,9,25,2.4
46109,4739,4594,0,9,145,3.1
46111,1221,1199,0,9,22,1.8
46115,3012,2946,0,9,66,2.2
46117,1955,1920,0,9,35,1.8
46119,828,815,0,9,13,1.6
46121,3034,2932,0,9,102,3.4
46123,3081,3031,0,9,50,1.6
46125,4838,4748,1,2,90,1.9
46127,8726,8540,1,3,186,2.1
46129,2075,2009,0,9,66,3.2
46135,11915,11706,0,7,209,1.8
46137,962,920,0,9,42,4.4
47000,3379605,3267935,,,111670,3.3
47001,35580,34429,1,2,1151,3.2
47003,21848,21126,0,4,722,3.3
47005,6785,6505,0,9,280,4.1
47007,4474,4235,0,8,239,5.3
47009,66080,64092,1,2,1988,3
47011,50251,48485,1,3,1766,3.5
47013,15098,14472,1,2,626,4.1
47015,6984,6779,1,1,205,2.9
47017,11765,11283,0,6,482,4.1
47019,24082,23198,1,3,884,3.7
47021,22947,22356,1,1,591,2.6
47023,8493,8227,1,3,266,3.1
47025,12803,12299,0,6,504,3.9
47027,2849,2724,0,8,125,4.4
47029,14769,14100,0,6,669,4.5
47031,25544,24681,0,4,863,3.4
47033,6806,6584,1,3,222,3.3
47035,23766,22774,0,4,992,4.2
47037,419758,408625,1,1,11133,2.7
47039,4359,4162,0,9,197,4.5
47041,7707,7388,0,8,319,4.1
47043,28374,27598,1,1,776,2.7
47045,16700,16110,0,6,590,3.5
47047,19008,18318,1,1,690,3.6
47049,7700,7406,0,8,294,3.8
47051,19520,18846,0,7,674,3.5
47053,21666,20911,1,3,755,3.5
47055,14738,14253,0,6,485,3.3
47057,9787,9428,1,2,359,3.7
47059,28645,27456,0,4,1189,4.2
47061,5059,4833,0,8,226,4.5
47063,28092,27092,1,3,1000,3.6
47065,188594,182553,1,2,6041,3.2
47067,2269,2169,0,8,100,4.4
47069,8807,8417,0,6,390,4.4
47071,10152,9750,0,6,402,4
47073,23251,22350,1,2,901,3.9
47075,8130,7776,0,6,354,4.4
47077,11707,11274,0,6,433,3.7
47079,13629,13113,0,7,516,3.8
47081,11921,11589,1,1,332,2.8
47083,3203,3057,0,8,146,4.6
47085,8874,8585,0,8,289,3.3
47087,4793,4598,0,8,195,4.1
47089,24960,24074,1,3,886,3.5
47091,7484,7246,0,8,238,3.2
47093,253277,246156,1,2,7121,2.8
47095,1609,1540,0,9,69,4.3
47097,9337,8864,0,6,473,5.1
47099,19325,18653,0,6,672,3.5
47101,5529,5344,0,8,185,3.3
47103,16653,16128,0,6,525,3.2
47105,24619,23816,1,2,803,3.3
47107,21176,20288,0,4,888,4.2
47109,8358,7964,0,8,394,4.7
47111,11863,11497,1,1,366,3.1
47113,48687,47059,1,3,1628,3.3
47115,12665,12169,1,2,496,3.9
47117,15744,15244,0,6,500,3.2
47119,53782,52302,1,1,1480,2.8
47121,4965,4719,0,8,246,5
47123,20655,19911,0,6,744,3.6
47125,89396,86066,1,2,3330,3.7
47127,3673,3581,0,9,92,2.5
47129,7952,7630,1,2,322,4
47131,12919,12426,0,7,493,3.8
47133,10109,9753,0,9,356,3.5
47135,2830,2684,0,9,146,5.2
47137,2131,2044,0,9,87,4.1
47139,7064,6788,1,3,276,3.9
47141,35173,33953,0,4,1220,3.5
47143,13367,12764,0,6,603,4.5
47145,23993,23120,1,2,873,3.6
47147,39904,38818,1,1,1086,2.7
47149,199154,193939,1,1,5215,2.6
47151,8176,7786,0,8,390,4.8
47153,6330,6082,1,2,248,3.9
47155,56065,54379,0,4,1686,3
47157,431889,413103,1,1,18786,4.3
47159,9930,9631,1,1,299,3
47161,5694,5489,1,2,205,3.6
47163,69003,66605,1,2,2398,3.5
47165,110576,107670,1,1,2906,2.6
47167,27320,26290,1,1,1030,3.8
47169,5838,5655,1,1,183,3.1
47171,7070,6773,1,3,297,4.2
47173,7912,7614,1,2,298,3.8
47175,2127,2031,0,9,96,4.5
47177,16767,16073,0,6,694,4.1
47179,61502,59492,1,3,2010,3.3
47181,6472,6213,0,8,259,4
47183,15038,14493,0,6,545,3.6
47185,12060,11634,0,7,426,3.5
47187,140569,137104,1,1,3465,2.5
47189,83551,81274,1,1,2277,2.7
48000,15067153,14472524,,,594629,3.9
48001,22844,22038,0,7,806,3.5
48003,9373,9092,0,6,281,3
48005,35036,33506,0,5,1530,4.4
48007,9522,9057,1,2,465,4.9
48009,4035,3893,1,3,142,3.5
48011,948,917,1,2,31,3.3
48013,22990,22115,1,1,875,3.8
48015,14498,13965,1,1,533,3.7
48017,2329,2219,0,6,110,4.7
48019,10854,10472,1,1,382,3.5
48021,49984,48279,1,1,1705,3.4
48023,1883,1835,0,9,48,2.5
48025,9348,8870,0,6,478,5.1
48027,151178,144385,1,2,6793,4.5
48029,1004146,966616,1,1,37530,3.7
48031,7460,7254,0,8,206,2.8
48033,736,723,0,9,13,1.8
48035,8800,8492,1,2,308,3.5
48037,38549,36919,1,3,1630,4.2
48039,190151,181815,1,1,8336,4.4
48041,132605,128488,1,2,4117,3.1
48043,4417,4274,0,7,143,3.2
48045,613,590,0,8,23,3.8
48047,2295,2168,0,9,127,5.5
48049,15724,15048,0,5,676,4.3
48051,9119,8789,1,2,330,3.6
48053,26549,25729,0,6,820,3.1
48055,22091,21310,1,1,781,3.5
48057,12079,11678,0,6,401,3.3
48059,6398,6168,1,3,230,3.6
48061,181270,171454,1,2,9816,5.4
48063,5138,4913,0,8,225,4.4
48065,3029,2939,1,2,90,3
48067,11998,11435,0,6,563,4.7
48069,3341,3239,0,9,102,3.1
48071,21715,20550,1,1,1165,5.4
48073,20774,19859,0,6,915,4.4
48075,3213,3124,0,9,89,2.8
48077,4876,4694,1,3,182,3.7
48079,1138,1093,1,2,45,4
48081,1614,1560,0,8,54,3.3
48083,3066,2926,0,8,140,4.6
48085,644705,622134,1,1,22571,3.5
48087,1109,1069,0,9,40,3.6
48089,10572,10207,0,8,365,3.5
48091,84437,81394,1,1,3043,3.6
48093,6267,6044,0,9,223,3.6
48095,1339,1297,0,8,42,3.1
48097,20583,19898,0,6,685,3.3
48099,24964,23845,1,2,1119,4.5
48101,951,926,0,9,25,2.6
48103,1726,1649,0,8,77,4.5
48105,1503,1453,0,8,50,3.3
48107,2429,2327,1,2,102,4.2
48109,1246,1206,0,9,40,3.2
48111,3903,3803,0,7,100,2.6
48113,1461604,1405512,1,1,56092,3.8
48115,4445,4257,0,6,188,4.2
48117,8959,8679,0,6,280,3.1
48119,2512,2400,0,8,112,4.5
48121,568450,548549,1,1,19901,3.5
48123,9114,8812,0,6,302,3.3
48125,608,577,0,8,31,5.1
48127,6288,6085,0,7,203,3.2
48129,1447,1391,0,8,56,3.9
48131,4987,4768,0,9,219,4.4
48133,6563,6261,0,8,302,4.6
48135,86162,83293,1,3,2869,3.3
48137,1264,1233,0,9,31,2.5
48139,106348,102421,1,1,3927,3.7
48141,378938,362318,1,2,16620,4.4
48143,21573,20816,0,5,757,3.5
48145,6941,6658,1,2,283,4.1
48147,18049,17436,0,6,613,3.4
48149,12198,11787,0,6,411,3.4
48151,1633,1579,0,8,54,3.3
48153,2438,2334,0,8,104,4.3
48155,577,558,0,9,19,3.3
48157,432297,415144,1,1,17153,4
48159,5157,4962,0,9,195,3.8
48161,6584,6248,0,9,336,5.1
48163,9383,9078,0,6,305,3.3
48165,10454,10150,0,6,304,2.9
48167,174213,166796,1,1,7417,4.3
48169,1981,1913,1,2,68,3.4
48171,14739,14358,0,7,381,2.6
48173,901,879,0,8,22,2.4
48175,3185,3066,1,3,119,3.7
48177,9505,9178,0,6,327,3.4
48179,7770,7451,0,6,319,4.1
48181,69425,66861,1,3,2564,3.7
48183,58130,55674,1,2,2456,4.2
48185,11882,11359,0,6,523,4.4
48187,87830,84847,1,1,2983,3.4
48189,11434,10876,0,4,558,4.9
48191,1078,1032,0,9,46,4.3
48193,3844,3714,0,8,130,3.4
48195,2804,2731,0,9,73,2.6
48197,1745,1662,0,9,83,4.8
48199,25350,24107,1,2,1243,4.9
48201,2414902,2312228,1,1,102674,4.3
48203,28558,27219,1,2,1339,4.7
48205,2589,2535,0,9,54,2.1
48207,2431,2338,0,8,93,3.8
48209,144229,139520,1,1,4709,3.3
48211,1559,1504,0,9,55,3.5
48213,39813,38192,0,4,1621,4.1
48215,378591,355519,1,2,23072,6.1
48217,17982,17256,0,6,726,4
48219,10768,10377,1,2,391,3.6
48221,30595,29468,0,4,1127,3.7
48223,18918,18261,0,6,657,3.5
48225,10702,10355,0,7,347,3.2
48227,12906,12357,0,4,549,4.3
48229,1906,1834,1,2,72,3.8
48231,48174,46182,1,1,1992,4.1
48233,8486,8119,0,6,367,4.3
48235,798,772,1,3,26,3.3
48237,3464,3341,0,8,123,3.6
48239,7135,6898,0,6,237,3.3
48241,12224,11458,0,6,766,6.3
48243,1005,973,0,9,32,3.2
48245,103246,96784,1,2,6462,6.3
48247,1851,1764,0,8,87,4.7
48249,15787,14967,0,6,820,5.2
48251,91344,88059,1,1,3285,3.6
48253,5940,5666,1,3,274,4.6
48255,6758,6547,0,8,211,3.1
48257,77440,74279,1,1,3161,4.1
48259,24335,23528,1,1,807,3.3
48261,127,118,0,9,9,7.1
48263,606,593,0,9,13,2.1
48265,22557,21761,0,4,796,3.5
48267,1794,1733,0,9,61,3.4
48269,497,492,0,9,5,1
48271,1261,1203,0,9,58,4.6
48273,13171,12560,0,4,611,4.6
48275,1522,1468,0,9,54,3.5
48277,23849,22827,0,5,1022,4.3
48279,5091,4880,0,6,211,4.1
48281,9535,9173,1,2,362,3.8
48283,4070,3965,0,8,105,2.6
48285,9299,8993,0,8,306,3.3
48287,9316,9021,0,8,295,3.2
48289,6558,6248,0,8,310,4.7
48291,36244,34259,1,1,1985,5.5
48293,9103,8719,0,6,384,4.2
48295,1457,1411,0,9,46,3.2
48297,5029,4838,0,8,191,3.8
48299,9812,9460,0,7,352,3.6
48301,1601,1596,0,9,5,0.3
48303,165713,160188,1,2,5525,3.3
48305,2876,2782,1,2,94,3.3
48307,3113,2985,0,9,128,4.1
48309,129409,124650,1,2,4759,3.7
48311,829,815,0,8,14,1.7
48313,4744,4525,0,8,219,4.6
48315,4348,4140,0,8,208,4.8
48317,2923,2845,1,3,78,2.7
48319,1853,1789,0,9,64,3.5
48321,17135,16206,0,6,929,5.4
48323,23770,21990,1,3,1780,7.5
48325,23213,22333,1,1,880,3.8
48327,849,818,0,9,31,3.7
48329,111773,108999,1,3,2774,2.5
48331,10911,10457,0,6,454,4.2
48333,1867,1794,0,9,73,3.9
48335,2338,2245,0,7,93,4
48337,9567,9230,0,6,337,3.5
48339,311467,299211,1,1,12256,3.9
48341,11299,10995,0,7,304,2.7
48343,4543,4276,0,8,267,5.9
48345,506,486,0,8,20,4
48347,28131,26910,0,5,1221,4.3
48349,23823,22881,0,4,942,4
48351,4990,4637,0,8,353,7.1
48353,6859,6620,0,6,239,3.5
48355,168426,161292,1,2,7134,4.2
48357,3987,3854,0,7,133,3.3
48359,942,914,1,2,28,3
48361,35460,33544,1,2,1916,5.4
48363,13348,12850,0,6,498,3.7
48365,9639,9210,0,6,429,4.5
48367,76471,73916,1,1,2555,3.3
48369,5121,4987,0,9,134,2.6
48371,6259,6036,0,7,223,3.6
48373,19046,18026,0,6,1020,5.4
48375,55594,53852,1,2,1742,3.1
48377,3038,2848,0,9,190,6.3
48379,6702,6468,0,8,234,3.5
48381,76911,74649,1,2,2262,2.9
48383,1571,1515,0,8,56,3.6
48385,1103,1047,0,9,56,5.1
48387,5027,4788,0,8,239,4.8
48389,9177,8894,0,7,283,3.1
48391,3085,2966,0,8,119,3.9
48393,389,375,0,9,14,3.6
48395,8178,7880,1,2,298,3.6
48397,61012,58820,1,1,2192,3.6
48399,4677,4494,0,8,183,3.9
48401,22842,21916,1,2,926,4.1
48403,3603,3358,0,9,245,6.8
48405,3315,3137,0,9,178,5.4
48407,12580,11993,1,1,587,4.7
48409,29808,28375,1,2,1433,4.8
48411,2221,2137,0,9,84,3.8
48413,1170,1129,0,8,41,3.5
48415,6324,6065,0,7,259,4.1
48417,1890,1839,0,8,51,2.7
48419,11227,10727,0,7,500,4.5
48421,1331,1289,0,9,42,3.2
48423,115419,111221,1,3,4198,3.6
48425,4674,4506,0,8,168,3.6
48427,24458,22172,0,4,2286,9.3
48429,3993,3839,0,7,154,3.9
48431,501,481,0,8,20,4
48433,815,793,0,9,22,2.7
48435,1040,980,0,9,60,5.8
48437,2571,2454,0,8,117,4.6
48439,1170758,1127271,1,1,43487,3.7
48441,70268,67916,1,3,2352,3.3
48443,374,361,0,9,13,3.5
48445,4607,4427,0,6,180,3.9
48447,676,652,0,9,24,3.6
48449,13708,13131,0,7,577,4.2
48451,56492,54515,1,3,1977,3.5
48453,857916,829904,1,1,28012,3.3
48455,5302,5039,0,8,263,5
48457,7104,6689,0,8,415,5.8
48459,18174,17405,1,2,769,4.2
48461,3269,3213,0,8,56,1.7
48463,11269,10795,0,6,474,4.2
48465,22215,21003,0,5,1212,5.5
48467,28676,27660,0,8,1016,3.5
48469,41477,39795,1,3,1682,4.1
48471,24262,23148,0,4,1114,4.6
48473,26291,25093,1,1,1198,4.6
48475,6567,6368,0,6,199,3
48477,15921,15293,0,6,628,3.9
48479,120663,115845,1,2,4818,4
48481,21704,20868,0,4,836,3.9
48483,2069,1993,0,9,76,3.7
48485,55822,53646,1,3,2176,3.9
48487,4968,4722,0,6,246,5
48489,7118,6564,0,6,554,7.8
48491,380582,367668,1,1,12914,3.4
48493,26609,25761,1,1,848,3.2
48495,4188,4045,0,6,143,3.4
48497,35165,33880,1,1,1285,3.7
48499,18471,17662,0,6,809,4.4
48501,3414,3298,0,9,116,3.4
48503,8208,7931,0,7,277,3.4
48505,4424,4141,0,6,283,6.4
48507,3470,3216,0,7,254,7.3
49000,1790381,1743223,,,47158,2.6
49001,3006,2917,0,9,89,3
49003,28655,27943,0,4,712,2.5
49005,71591,69954,1,3,1637,2.3
49007,8488,8176,0,7,312,3.7
49009,407,390,0,9,17,4.2
49011,190367,185764,1,2,4603,2.4
49013,8554,8308,0,7,246,2.9
49015,4755,4608,0,9,147,3.1
49017,2817,2636,0,9,181,6.4
49019,7063,6810,0,7,253,3.6
49021,29099,28343,0,4,756,2.6
49023,6558,6404,1,2,154,2.3
49025,4229,4113,0,8,116,2.7
49027,6532,6379,0,9,153,2.3
49029,6143,6015,1,2,128,2.1
49031,514,489,0,9,25,4.9
49033,1354,1322,0,8,32,2.4
49035,693701,675303,1,1,18398,2.7
49037,5876,5640,0,9,236,4
49039,14110,13702,0,6,408,2.9
49041,10574,10278,0,7,296,2.8
49043,27401,26733,0,4,668,2.4
49045,39076,37983,1,1,1093,2.8
49047,14938,14449,0,7,489,3.3
49049,353125,344042,1,2,9083,2.6
49051,18659,18208,0,4,451,2.4
49053,91377,88839,1,3,2538,2.8
49055,1596,1528,0,9,68,4.3
49057,139820,135950,1,2,3870,2.8
5000,1377657,1332876,,,44781,3.3
50000,350886,343840,,,7046,2
50001,21467,21099,0,6,368,1.7
50003,18134,17685,0,6,449,2.5
50005,15042,14690,0,9,352,2.3
50007,100207,98640,1,3,1567,1.6
50009,2751,2671,0,9,80,2.9
5001,9100,8858,0,6,242,2.7
50011,28514,27987,1,3,527,1.8
50013,4226,4138,1,3,88,2.1
50015,14575,14213,0,8,362,2.5
50017,16082,15756,0,9,326,2
50019,13659,13188,0,9,471,3.4
50021,30204,29478,0,7,726,2.4
50023,34615,33930,0,4,685,2
50025,21746,21242,0,7,504,2.3
50027,29663,29123,0,7,540,1.8
5003,6450,6087,0,7,363,5.6
5005,16806,16204,0,7,602,3.6
5007,154952,151167,1,2,3785,2.4
5009,15848,15352,0,7,496,3.1
5011,4037,3850,0,7,187,4.6
5013,2353,2284,0,9,69,2.9
5015,12299,11938,0,6,361,2.9
5017,2851,2687,0,9,164,5.8
5019,8499,8098,0,7,401,4.7
5021,5381,5159,0,9,222,4.1
5023,8996,8642,0,6,354,3.9
5025,3054,2948,0,8,106,3.5
5027,8764,8388,0,7,376,4.3
5029,8314,8001,0,6,313,3.8
5031,57392,55816,1,3,1576,2.7
5033,26514,25622,1,3,892,3.4
5035,20358,19500,1,1,858,4.2
5037,6816,6584,0,6,232,3.4
5039,2647,2543,0,8,104,3.9
5041,4888,4663,0,9,225,4.6
5043,7369,7063,0,7,306,4.2
5045,64394,62538,1,2,1856,2.9
5047,7434,7195,0,8,239,3.2
5049,4523,4349,0,9,174,3.8
5051,41570,40036,1,3,1534,3.7
5053,8608,8362,1,2,246,2.9
5055,19693,19041,0,4,652,3.3
5057,9141,8833,0,6,308,3.4
5059,13704,13218,0,6,486,3.5
5061,5246,5065,0,8,181,3.5
5063,16834,16260,0,7,574,3.4
5065,4476,4248,0,9,228,5.1
5067,5385,5110,0,6,275,5.1
5069,25365,24195,0,4,1170,4.6
5071,9849,9419,0,7,430,4.4
5073,2201,2094,0,8,107,4.9
5075,6764,6537,0,6,227,3.4
5077,2547,2415,0,8,132,5.2
5079,3657,3511,0,9,146,4
5081,5165,4985,1,3,180,3.5
5083,8270,7939,0,8,331,4
5085,34884,33929,1,2,955,2.7
5087,7918,7716,1,2,202,2.6
5089,6050,5801,0,9,249,4.1
5091,18633,17955,1,3,678,3.6
5093,16776,15950,0,4,826,4.9
5095,2465,2368,0,9,97,3.9
5097,2895,2753,0,8,142,4.9
5099,3355,3232,0,9,123,3.7
51000,4555208,4424155,,,131053,2.9
51001,16202,15631,0,9,571,3.5
51003,59824,58244,1,3,1580,2.6
51005,6491,6264,0,6,227,3.5
51007,6468,6272,1,1,196,3
51009,15004,14526,1,2,478,3.2
5101,3191,3083,0,9,108,3.4
51011,7246,6982,1,2,264,3.6
51013,161376,157923,1,1,3453,2.1
51015,39486,38500,1,3,986,2.5
51017,2417,2349,0,9,68,2.8
51019,38930,37800,1,2,1130,2.9
51021,2851,2766,0,8,85,3
51023,18119,17658,1,2,461,2.5
51025,6023,5746,0,8,277,4.6
51027,6424,6140,0,9,284,4.4
51029,6627,6367,0,8,260,3.9
5103,9629,9257,0,7,372,3.9
51031,26152,25293,1,2,859,3.3
51033,15825,15334,0,8,491,3.1
51035,12965,12479,0,6,486,3.7
51036,3710,3592,1,1,118,3.2
51037,5344,5158,0,8,186,3.5
51041,200078,194334,1,1,5744,2.9
51043,7858,7661,1,1,197,2.5
51045,2374,2297,1,2,77,3.2
51047,26178,25458,1,1,720,2.8
51049,4843,4673,0,8,170,3.5
5105,4301,4146,1,2,155,3.6
51051,4634,4432,0,9,202,4.4
51053,14201,13739,1,1,462,3.3
51057,5679,5471,0,8,208,3.7
51059,656494,640201,1,1,16293,2.5
51061,38687,37710,1,1,977,2.5
51063,8721,8493,1,3,228,2.6
51065,14653,14281,1,3,372,2.5
51067,27140,26330,1,2,810,3
51069,53331,52005,1,3,1326,2.5
5107,5240,4900,0,7,340,6.5
51071,8356,8115,1,3,241,2.9
51073,20049,19518,1,1,531,2.6
51075,12203,11855,1,1,348,2.9
51077,8300,8073,0,9,227,2.7
51079,10972,10697,1,3,275,2.5
51081,4297,4136,0,6,161,3.7
51083,15730,15106,0,6,624,4
51085,62020,60464,1,1,1556,2.5
51087,191583,186040,1,1,5543,2.9
51089,24244,23403,0,4,841,3.5
5109,4023,3884,0,9,139,3.5
51091,1506,1471,0,8,35,2.3
51093,20247,19675,1,1,572,2.8
51095,38032,36964,1,1,1068,2.8
51097,3978,3872,1,1,106,2.7
51099,14913,14521,0,8,392,2.6
51101,9860,9593,1,1,267,2.7
51103,5745,5531,0,9,214,3.7
51105,8342,8025,0,8,317,3.8
51107,239037,233028,1,1,6009,2.5
51109,21087,20527,0,8,560,2.7
5111,9917,9587,1,3,330,3.3
51111,5355,5177,0,9,178,3.3
51113,7699,7522,0,8,177,2.3
51115,4206,4088,1,1,118,2.8
51117,13414,12936,0,7,478,3.6
51119,5323,5179,0,8,144,2.7
51121,53757,52247,1,3,1510,2.8
51125,7565,7360,1,3,205,2.7
51127,13672,13322,1,1,350,2.6
5113,7744,7463,0,7,281,3.6
51131,5647,5447,0,8,200,3.5
51133,5609,5370,0,9,239,4.3
51135,7383,7164,0,8,219,3
51137,17888,17346,0,6,542,3
51139,12712,12273,0,8,439,3.5
51141,7319,7063,0,8,256,3.5
51143,31010,30056,0,4,954,3.1
51145,15148,14746,1,1,402,2.7
51147,10198,9776,0,6,422,4.1
51149,15892,15354,1,1,538,3.4
5115,28530,27428,0,5,1102,3.9
51153,257986,250922,1,1,7064,2.7
51155,17152,16672,1,3,480,2.8
51157,3793,3695,1,1,98,2.6
51159,4020,3894,0,9,126,3.1
51161,51148,49833,1,2,1315,2.6
51163,11012,10711,0,6,301,2.7
51165,44024,42916,1,3,1108,2.5
51167,11233,10825,0,8,408,3.6
51169,9391,9088,1,2,303,3.2
5117,3522,3413,0,8,109,3.1
51171,22738,22131,0,6,607,2.7
51173,14101,13650,0,7,451,3.2
51175,9260,9023,0,6,237,2.6
51177,71382,69237,1,1,2145,3
51179,77864,75580,1,1,2284,2.9
51181,3764,3664,1,1,100,2.7
51183,3774,3621,1,1,153,4.1
51185,15511,14888,0,7,623,4
51187,21302,20694,1,1,608,2.9
5119,193033,186868,1,2,6165,3.2
51191,26928,26134,1,2,794,2.9
51193,9610,9296,0,8,314,3.3
51195,12967,12427,0,7,540,4.2
51197,14514,14082,0,6,432,3
51199,34187,33251,1,1,936,2.7
5121,7075,6824,0,7,251,3.5
5123,7455,7084,0,6,371,5
5125,61267,59598,1,2,1669,2.7
5127,4379,4247,0,8,132,3
5129,2875,2750,0,9,125,4.3
5131,55851,53953,1,3,1898,3.4
5133,5439,5234,0,6,205,3.8
5135,5940,5706,0,9,234,3.9
5137,4542,4355,0,9,187,4.1
5139,14751,14067,0,7,684,4.6
5141,5940,5701,0,8,239,4
5143,136783,133649,1,2,3134,2.3
5145,33782,32610,0,4,1172,3.5
5147,2843,2742,0,9,101,3.6
5149,8122,7822,0,9,300,3.7
51510,103591,101169,1,1,2422,2.3
51520,7747,7464,1,2,283,3.7
51530,3536,3442,0,6,94,2.7
51540,26504,25858,1,3,646,2.4
51550,127691,123987,1,1,3704,2.9
51570,8804,8529,1,1,275,3.1
51580,2276,2182,0,6,94,4.1
51590,19192,18315,0,4,877,4.6
51595,2311,2205,0,6,106,4.6
51600,13266,12943,1,1,323,2.4
51610,8810,8604,1,1,206,2.3
51620,3544,3408,0,6,136,3.8
51630,14788,14285,1,1,503,3.4
51640,2902,2790,0,6,112,3.9
51650,66324,63855,1,1,2469,3.7
51660,25665,24766,1,3,899,3.5
51670,9961,9519,1,1,442,4.4
51678,2327,2224,0,6,103,4.4
51680,36252,34719,1,2,1533,4.2
51683,22325,21767,1,1,558,2.5
51685,10066,9809,1,1,257,2.6
51690,5627,5361,0,4,266,4.7
51700,90964,87869,1,1,3095,3.4
51710,113430,109605,1,1,3825,3.4
51720,1624,1557,0,7,67,4.1
51730,13010,12302,1,1,708,5.4
51735,6553,6389,1,1,164,2.5
51740,45365,43708,1,1,1657,3.7
51750,9309,8974,1,3,335,3.6
51760,124807,120442,1,1,4365,3.5
51770,50330,48723,1,2,1607,3.2
51775,13249,12859,1,2,390,2.9
51790,12866,12528,1,3,338,2.6
51800,46999,45550,1,1,1449,3.1
51810,239035,232278,1,1,6757,2.8
51820,11195,10868,1,3,327,2.9
51830,7017,6734,1,1,283,4
51840,15632,15188,1,3,444,2.8
53000,4025762,3860883,,,164879,4.1
53001,9621,9178,0,6,443,4.6
53003,10627,10265,1,3,362,3.4
53005,106395,101561,1,2,4834,4.5
53007,44441,42544,1,3,1897,4.3
53009,29454,27910,0,5,1544,5.2
53011,248604,237865,1,1,10739,4.3
53013,1727,1651,0,8,76,4.4
53015,48526,46067,1,3,2459,5.1
53017,21770,20751,1,3,1019,4.7
53019,2296,2104,0,8,192,8.4
53021,43474,40996,1,2,2478,5.7
53023,782,739,0,8,43,5.5
53025,48716,46160,0,5,2556,5.2
53027,28921,27092,0,4,1829,6.3
53029,37163,35551,0,4,1612,4.3
53031,12505,11877,0,6,628,5
53033,1348792,1302991,1,1,45801,3.4
53035,129099,123784,1,2,5315,4.1
53037,23171,21990,0,4,1181,5.1
53039,9677,9188,0,9,489,5.1
53041,34886,33004,0,4,1882,5.4
53043,4674,4447,0,8,227,4.9
53045,25427,24030,0,4,1397,5.5
53047,19564,18492,0,6,1072,5.5
53049,8542,8028,0,7,514,6
53051,5147,4838,0,8,309,6
53053,455090,433735,1,1,21355,4.7
53055,8711,8412,0,9,299,3.4
53057,61573,58731,1,3,2842,4.6
53059,5542,5276,1,1,266,4.8
53061,458599,442668,1,1,15931,3.5
53063,264059,252852,1,2,11207,4.2
53065,19189,18039,1,2,1150,6
53067,149840,143640,1,2,6200,4.1
53069,1365,1278,0,8,87,6.4
53071,30020,28774,1,3,1246,4.2
53073,115010,110037,1,3,4973,4.3
53075,23296,22354,0,4,942,4
53077,129472,121988,1,2,7484,5.8
54000,785642,754986,,,30656,3.9
54001,7163,6816,0,9,347,4.8
54003,59107,57095,1,2,2012,3.4
54005,7253,6948,1,3,305,4.2
54007,5056,4800,0,8,256,5.1
54009,9665,9180,1,3,485,5
54011,41405,39888,1,2,1517,3.7
54013,2479,2301,0,8,178,7.2
54015,3031,2855,1,3,176,5.8
54017,3710,3592,0,9,118,3.2
54019,15925,15223,1,3,702,4.4
54021,2245,2126,0,9,119,5.3
54023,6069,5841,0,9,228,3.8
54025,15155,14598,0,6,557,3.7
54027,11150,10833,1,3,317,2.8
54029,12839,12097,1,3,742,5.8
54031,5783,5532,0,8,251,4.3
54033,34137,33023,0,5,1114,3.3
54035,12092,11589,0,8,503,4.2
54037,31137,30301,1,1,836,2.7
54039,81989,79034,1,3,2955,3.6
54041,6221,5935,0,9,286,4.6
54043,7025,6684,0,8,341,4.9
54045,11344,10873,0,6,471,4.2
54047,4048,3788,0,9,260,6.4
54049,25037,24027,0,4,1010,4
54051,13151,12497,1,3,654,5
54053,10126,9665,0,6,461,4.6
54055,20639,19730,0,4,909,4.4
54057,12191,11692,0,7,499,4.1
54059,6462,6119,0,8,343,5.3
54061,55589,53863,1,3,1726,3.1
54063,5960,5781,0,8,179,3
54065,8513,8246,1,2,267,3.1
54067,9005,8587,0,8,418,4.6
54069,20009,19246,1,3,763,3.8
54071,3714,3616,0,8,98,2.6
54073,2664,2520,0,8,144,5.4
54075,3665,3500,0,9,165,4.5
54077,15474,14874,1,3,600,3.9
54079,26893,26010,1,2,883,3.3
54081,30112,29007,1,3,1105,3.7
54083,11751,11192,0,7,559,4.8
54085,4003,3832,0,8,171,4.3
54087,4979,4679,0,8,300,6
54089,4438,4266,0,8,172,3.9
54091,7909,7616,0,6,293,3.7
54093,3576,3453,0,9,123,3.4
54095,2915,2742,0,9,173,5.9
54097,9826,9372,0,7,454,4.6
54099,15568,14927,1,2,641,4.1
54101,3033,2878,0,9,155,5.1
54103,6462,6083,0,7,379,5.9
54105,2242,2112,1,3,130,5.8
54107,36481,34984,1,3,1497,4.1
54109,7233,6923,0,8,310,4.3
55000,3133909,3038960,,,94949,3
55001,8065,7654,0,8,411,5.1
55003,7530,7248,0,7,282,3.7
55005,23848,22997,0,6,851,3.6
55007,7406,7070,0,8,336,4.5
55009,142593,138725,1,2,3868,2.7
55011,6139,5868,0,8,271,4.4
55013,7407,7067,0,8,340,4.6
55015,27934,27272,1,3,662,2.4
55017,34158,32956,1,3,1202,3.5
55019,17400,16918,0,8,482,2.8
55021,32562,31715,1,2,847,2.6
55023,6968,6694,0,6,274,3.9
55025,339315,331631,1,2,7684,2.3
55027,48509,47239,0,4,1270,2.6
55029,15590,15117,0,6,473,3
55031,23065,22062,1,2,1003,4.3
55033,24335,23512,0,6,823,3.4
55035,60806,59161,1,3,1645,2.7
55037,2187,2112,0,9,75,3.4
55039,56335,54837,1,3,1498,2.7
55041,3947,3756,0,9,191,4.8
55043,26740,25962,0,6,778,2.9
55045,21256,20738,1,2,518,2.4
55047,9205,8891,0,6,314,3.4
55049,13843,13484,1,2,359,2.6
55051,2573,2432,0,9,141,5.5
55053,9227,8868,0,8,359,3.9
55055,46192,44919,0,4,1273,2.8
55057,13603,13169,0,8,434,3.2
55059,91612,88461,1,3,3151,3.4
55061,10830,10559,1,2,271,2.5
55063,67181,65458,1,3,1723,2.6
55065,10702,10458,0,8,244,2.3
55067,9226,8898,0,6,328,3.6
55069,14610,14140,0,6,470,3.2
55071,40702,39480,0,4,1222,3
55073,72746,70751,1,3,1995,2.7
55075,19056,18293,0,6,763,4
55077,7761,7471,0,8,290,3.7
55078,1515,1422,0,9,93,6.1
55079,466290,448733,1,1,17557,3.8
55081,23663,23029,0,4,634,2.7
55083,20753,20076,1,2,677,3.3
55085,18189,17563,0,7,626,3.4
55087,105917,103184,1,3,2733,2.6
55089,49543,48253,1,1,1290,2.6
55091,4158,4028,0,8,130,3.1
55093,24876,24010,1,1,866,3.5
55095,25191,24151,0,8,1040,4.1
55097,37818,36695,0,4,1123,3
55099,6389,6174,0,9,215,3.4
55101,99921,96372,1,3,3549,3.6
55103,8817,8551,0,8,266,3
55105,88555,85554,1,3,3001,3.4
55107,6384,6146,0,8,238,3.7
55109,50707,48919,1,1,1788,3.5
55111,35288,34354,0,4,934,2.6
55113,8104,7762,0,9,342,4.2
55115,20476,19862,0,6,614,3
55117,62608,61066,1,3,1542,2.5
55119,10696,10298,0,8,398,3.7
55121,14756,14246,0,8,510,3.5
55123,15253,14823,1,3,430,2.8
55125,10457,10044,0,9,413,3.9
55127,59115,57386,0,4,1729,2.9
55129,7682,7394,0,8,288,3.7
55131,77508,75531,1,1,1977,2.6
55133,226852,220851,1,1,6001,2.6
55135,25318,24548,0,6,770,3
55137,11223,10833,0,8,390,3.5
55139,93234,90754,1,3,2480,2.7
55141,33492,32307,0,4,1185,3.5
56000,295207,286669,,,8538,2.9
56001,21491,20932,0,4,559,2.6
56003,5160,4992,0,9,168,3.3
56005,23349,22726,0,5,623,2.7
56007,7252,7038,0,7,214,3
56009,7701,7521,0,6,180,2.3
56011,3886,3794,0,9,92,2.4
56013,19097,18451,0,7,646,3.4
56015,6439,6274,0,7,165,2.6
56017,2333,2273,0,9,60,2.6
56019,4374,4253,0,9,121,2.8
56021,48889,47438,1,3,1451,3
56023,9793,9510,0,9,283,2.9
56025,39602,38349,1,3,1253,3.2
56027,1168,1138,0,9,30,2.6
56029,15757,15306,0,7,451,2.9
56031,4259,4134,0,8,125,2.9
56033,16286,15843,0,7,443,2.7
56035,3979,3848,0,9,131,3.3
56037,20251,19575,0,5,676,3.3
56039,17327,16955,0,7,372,2.1
56041,9096,8807,0,7,289,3.2
56043,3843,3716,0,9,127,3.3
56045,3876,3795,0,9,81,2.1
6000,19308287,18388329,,,919958,4.8
6001,826102,792439,1,1,33663,4.1
6003,540,505,0,8,35,6.5
6005,14404,13673,0,6,731,5.1
6007,91910,87088,1,3,4822,5.2
6009,21956,21030,0,6,926,4.2
6011,10576,9202,0,6,1374,13
6013,550610,527843,1,1,22767,4.1
6015,9443,8904,0,7,539,5.7
6017,93670,89963,1,1,3707,4
6019,461040,426635,1,1,34405,7.5
6021,12792,11989,0,6,803,6.3
6023,59947,57189,0,5,2758,4.6
6025,73294,60637,1,3,12657,17.3
6027,8355,8039,0,6,316,3.8
6029,393736,360971,1,2,32765,8.3
6031,58232,53451,1,3,4781,8.2
6033,28706,27045,0,4,1661,5.8
6035,8624,8176,0,7,448,5.2
6037,5015629,4763587,1,1,252042,5
6039,64206,59404,1,1,4802,7.5
6041,132018,127638,1,1,4380,3.3
6043,7603,7216,0,8,387,5.1
6045,37377,35621,0,4,1756,4.7
6047,118932,108224,1,2,10708,9
6049,3265,3058,0,8,207,6.3
6051,9102,8755,0,7,347,3.8
6053,217665,202396,1,2,15269,7
6055,71973,69429,1,3,2544,3.5
6057,48838,46925,0,4,1913,3.9
6059,1588873,1532415,1,1,56458,3.6
6061,194719,187464,1,1,7255,3.7
6063,7423,6883,0,9,540,7.3
6065,1157871,1102297,1,1,55574,4.8
6067,731046,698518,1,1,32528,4.4
6069,32408,30475,1,1,1933,6
6071,1013665,966511,1,1,47154,4.7
6073,1596432,1534417,1,1,62015,3.9
6075,563326,544928,1,1,18398,3.3
6077,346764,325140,1,2,21624,6.2
6079,136314,131600,1,2,4714,3.5
6081,445393,431899,1,1,13494,3
6083,218248,209269,1,2,8979,4.1
6085,1038951,1002573,1,1,36378,3.5
6087,133217,125570,1,2,7647,5.7
6089,73889,70091,1,3,3798,5.1
6091,1332,1270,0,8,62,4.7
6093,16716,15649,0,7,1067,6.4
6095,203063,193619,1,2,9444,4.7
6097,247963,238991,1,2,8972,3.6
6099,244926,229171,1,2,15755,6.4
6101,46736,43098,1,3,3638,7.8
6103,26071,24552,0,4,1519,5.8
6105,4560,4301,0,8,259,5.7
6107,213303,191983,1,2,21320,10
6109,19979,18979,0,4,1000,5
6111,412931,395282,1,2,17649,4.3
6113,109753,104602,1,1,5151,4.7
6115,31878,29754,1,3,2124,6.7
72000,1197463,1127126,,,70337,5.9
72001,4574,4165,0,6,409,8.9
72003,13580,12639,1,2,941,6.9
72005,16515,15224,1,2,1291,7.8
72007,7136,6690,1,1,446,6.3
72009,6964,6429,1,1,535,7.7
72011,10219,9590,1,2,629,6.2
72013,26652,24879,1,3,1773,6.7
72015,4945,4479,1,3,466,9.4
72017,6463,5950,1,1,513,7.9
72019,8023,7410,1,1,613,7.6
72021,70782,67556,1,1,3226,4.6
72023,15186,14190,1,3,996,6.6
72025,52368,49873,1,1,2495,4.8
72027,10712,10033,1,3,679,6.3
72029,17795,17017,1,1,778,4.4
72031,66765,63981,1,1,2784,4.2
72033,8406,8054,1,1,352,4.2
72035,17750,16836,1,1,914,5.1
72037,3927,3659,1,1,268,6.8
72039,3993,3670,1,1,323,8.1
72041,16958,16135,1,1,823,4.9
72043,11277,10369,0,4,908,8.1
72045,5394,5001,1,1,393,7.3
72047,9586,8936,1,1,650,6.8
72049,1036,1018,0,9,18,1.7
72051,14857,14165,1,1,692,4.7
72053,11562,10765,1,1,797,6.9
72054,3594,3291,1,1,303,8.4
72055,4150,3667,0,6,483,11.6
72057,11557,10715,1,3,842,7.3
72059,5403,4795,1,2,608,11.3
72061,41553,40398,1,1,1155,2.8
72063,20623,19776,1,1,847,4.1
72065,15116,13955,1,3,1161,7.7
72067,6010,5729,1,3,281,4.7
72069,19293,17980,1,1,1313,6.8
72071,13552,12620,1,2,932,6.9
72073,4760,4300,0,6,460,9.7
72075,17141,15883,1,2,1258,7.3
72077,13636,12771,1,1,865,6.3
72079,5667,5138,1,3,529,9.3
72081,7769,6992,0,4,777,10
72083,2929,2650,0,8,279,9.5
72085,12598,11788,1,1,810,6.4
72087,9019,8556,1,1,463,5.1
72089,6733,6299,1,1,434,6.4
72091,12240,11527,1,1,713,5.8
72093,2190,1990,0,8,200,9.1
72095,3171,2767,1,1,404,12.7
72097,24367,22706,1,3,1661,6.8
72099,12002,11063,1,2,939,7.8
72101,8836,8218,1,1,618,7
72103,9031,8499,1,1,532,5.9
72105,7706,7198,1,1,508,6.6
72107,5325,4864,1,1,461,8.7
72109,4406,3963,1,3,443,10.1
72111,6224,5584,1,2,640,10.3
72113,49000,45612,1,2,3388,6.9
72115,6722,6234,1,3,488,7.3
72117,5418,4883,1,2,535,9.9
72119,18479,17596,1,1,883,4.8
72121,6433,5900,1,3,533,8.3
72123,7598,6905,0,4,693,9.1
72125,10518,9693,1,3,825,7.8
72127,146265,140088,1,1,6177,4.2
72129,12689,11892,1,1,797,6.3
72131,11406,10332,1,2,1074,9.4
72133,8485,7764,0,6,721,8.5
72135,30478,29213,1,1,1265,4.2
72137,31631,30319,1,1,1312,4.1
72139,29476,28673,1,1,803,2.7
72141,7526,6883,0,6,643,8.5
72143,10599,10020,1,1,579,5.5
72145,14333,13276,1,1,1057,7.4
72147,2720,2603,0,6,117,4.3
72149,7819,6988,1,2,831,10.6
72151,9365,8583,1,1,782,8.4
72153,10488,9278,1,2,1210,11.5
8000,3230482,3128115,,,102367,3.2
8001,284585,274865,1,1,9720,3.4
8003,7945,7649,0,7,296,3.7
8005,378591,366811,1,1,11780,3.1
8007,6820,6599,0,7,221,3.2
8009,2038,1997,0,9,41,2
8011,1786,1732,0,9,54,3
8013,202678,196908,1,2,5770,2.8
8014,43062,41759,1,1,1303,3
8015,10009,9708,0,6,301,3
8017,1038,1016,0,9,22,2.1
8019,6197,6024,1,1,173,2.8
8021,3854,3726,0,9,128,3.3
8023,1802,1722,0,9,80,4.4
8025,1348,1291,0,8,57,4.2
8027,2198,2128,0,8,70,3.2
8029,13605,13112,0,6,493,3.6
8031,441205,426428,1,1,14777,3.3
8033,1106,1074,0,9,32,2.9
8035,210345,204268,1,1,6077,2.9
8037,34923,34007,0,5,916,2.6
8039,16119,15693,1,1,426,2.6
8041,365168,352979,1,2,12189,3.3
8043,14325,13629,0,4,696,4.9
8045,31455,30539,0,5,916,2.9
8047,3958,3852,1,1,106,2.7
8049,9377,9121,0,9,256,2.7
8051,11419,11121,0,7,298,2.6
8053,409,397,0,9,12,2.9
8055,2462,2318,0,8,144,5.8
8057,928,908,0,9,20,2.2
8059,346425,336212,1,1,10213,2.9
8061,868,849,0,9,19,2.2
8063,4125,4049,0,9,76,1.8
8065,4937,4813,0,9,124,2.5
8067,30889,29976,0,6,913,3
8069,214249,208186,1,2,6063,2.8
8071,5934,5638,0,7,296,5
8073,2231,2168,0,8,63,2.8
8075,10043,9770,0,6,273,2.7
8077,76553,73894,1,3,2659,3.5
8079,479,467,0,9,12,2.5
8081,6909,6685,0,7,224,3.2
8083,12010,11534,0,6,476,4
8085,21339,20641,0,5,698,3.3
8087,15381,14917,0,6,464,3
8089,7664,7346,0,6,318,4.1
8091,2455,2377,0,9,78,3.2
8093,11706,11378,1,1,328,2.8
8095,2404,2352,0,9,52,2.2
8097,10785,10426,0,7,359,3.3
8099,6150,5978,0,7,172,2.8
8101,75732,72379,1,3,3353,4.4
8103,2737,2647,0,9,90,3.3
8105,5209,5002,0,9,207,4
8107,16098,15688,0,7,410,2.5
8109,3369,3250,0,9,119,3.5
8111,579,564,0,9,15,2.6
8113,5624,5442,0,9,182,3.2
8115,1098,1064,0,9,34,3.1
8117,22136,21633,0,5,503,2.3
8119,13615,13204,1,2,411,3
8121,2677,2615,0,9,62,2.3
8123,171959,166337,1,2,5622,3.3
8125,5364,5256,0,9,108,2
9000,1893200,1822088,,,71112,3.8
9001,479451,460916,,,18535,3.9
9003,472925,455067,,,17858,3.8
9005,103429,99887,,,3542,3.4
9007,93043,90036,,,3007,3.2
9009,463284,445197,,,18087,3.9
9011,132752,127951,,,4801,3.6
9013,85542,82699,,,2843,3.3
9015,62773,60335,,,2438,3.9
9110,,,1,1,,
9120,,,1,2,,
9130,,,1,1,,
9140,,,1,2,,
9150,,,0,4,,
9160,,,0,4,,
9170,,,1,2,,
9180,,,1,2,,
9190,,,1,2,,
